AccountName,AccountID,BeginningBalance,TransactionDate,TransactionType,TransactionTypeID,DocumentNumber,VendorName,VendorID,Memo,Split,SplitID,TransactionAmount,NewAccountBalance
1100 Cash,565,,,,,,,,,,,,
1101 Saints JFX Oper. Acct. #2264,NA,,,,,,,,,,,,
,,-13100,,,,,,,,,,,
,,,1/19/2021,Transfer,4505,NA,NA,NA,transfer debit,1132.02 Cash:Auxiliary Accounts:St Joseph Auxiliary Accounts:St Joseph Men's Club #9953,314,-22.83,-13122.83
1101.10 Checking Available,691,,,,,,,,,,,,
,,18350.75,,,,,,,,,,,
,,,1/1/2021,Journal Entry,10581,GC 210101,NA,NA,NA,-Split-,NA,400,18750.75
,,,1/1/2021,Journal Entry,10581,GC 210101,NA,NA,NA,-Split-,NA,4878,23628.75
,,,1/1/2021,Journal Entry,10581,GC 210101,NA,NA,NA,-Split-,NA,1017,24645.75
,,,1/1/2021,Journal Entry,10581,GC 210101,NA,NA,NA,-Split-,NA,1735,26380.75
,,,1/1/2021,Journal Entry,10581,GC 210101,NA,NA,NA,-Split-,NA,350,26730.75
,,,1/1/2021,Journal Entry,10581,GC 210101,NA,NA,NA,-Split-,NA,2339.25,29070
,,,1/1/2021,Journal Entry,10581,GC 210101,NA,NA,NA,-Split-,NA,689.5,29759.5
,,,1/1/2021,Journal Entry,10581,GC 210101,NA,NA,NA,-Split-,NA,6064,35823.5
,,,1/1/2021,Journal Entry,10581,GC 210101,NA,NA,NA,-Split-,NA,252,36075.5
,,,1/1/2021,Journal Entry,10581,GC 210101,NA,NA,NA,-Split-,NA,1120,37195.5
,,,1/1/2021,Journal Entry,10581,GC 210101,NA,NA,NA,-Split-,NA,5112,42307.5
,,,1/1/2021,Journal Entry,10581,GC 210101,NA,NA,NA,-Split-,NA,620,42927.5
,,,1/1/2021,Journal Entry,10581,GC 210101,NA,NA,NA,-Split-,NA,3256.6,46184.1
,,,1/1/2021,Journal Entry,10581,GC 210101,NA,NA,NA,-Split-,NA,8902,55086.1
,,,1/1/2021,Journal Entry,10581,GC 210101,NA,NA,NA,-Split-,NA,1360,56446.1
,,,1/1/2021,Journal Entry,10581,GC 210101,NA,NA,NA,-Split-,NA,1761.5,58207.6
,,,1/1/2021,Journal Entry,10581,GC 210101,NA,NA,NA,-Split-,NA,6307,64514.6
,,,1/1/2021,Journal Entry,10581,GC 210101,NA,NA,NA,-Split-,NA,1875,66389.6
,,,1/1/2021,Journal Entry,10581,GC 210101,NA,NA,NA,-Split-,NA,-850,65539.6
,,,1/1/2021,Journal Entry,10581,GC 210101,NA,NA,NA,-Split-,NA,-100,65439.6
,,,1/1/2021,Journal Entry,10581,GC 210101,NA,NA,NA,-Split-,NA,-360,65079.6
,,,1/1/2021,Journal Entry,10581,GC 210101,NA,NA,NA,-Split-,NA,-100,64979.6
,,,1/1/2021,Journal Entry,10581,GC 210101,NA,NA,NA,-Split-,NA,-280,64699.6
,,,1/1/2021,Journal Entry,10581,GC 210101,NA,NA,capital projects,-Split-,NA,-850,63849.6
,,,1/1/2021,Journal Entry,10581,GC 210101,NA,NA,NA,-Split-,NA,-460,63389.6
,,,1/1/2021,Journal Entry,10581,GC 210101,NA,NA,NA,-Split-,NA,-1362,62027.6
,,,1/1/2021,Journal Entry,10581,GC 210101,NA,NA,soup kitchen,-Split-,NA,-350,61677.6
,,,1/1/2021,Journal Entry,10581,GC 210101,NA,NA,NA,-Split-,NA,-805,60872.6
,,,1/1/2021,Deposit,4352,NA,NA,NA,Smart201009 SFXS,-Split-,NA,2219.5,63092.1
,,,1/1/2021,Journal Entry,10581,GC 210101,NA,NA,NA,-Split-,NA,685,63777.1
,,,1/1/2021,Journal Entry,10581,GC 210101,NA,NA,NA,-Split-,NA,4970,68747.1
,,,1/1/2021,Journal Entry,10581,GC 210101,NA,NA,NA,-Split-,NA,6360,75107.1
,,,1/1/2021,Journal Entry,10581,GC 210101,NA,NA,NA,-Split-,NA,11425,86532.1
,,,1/1/2021,Journal Entry,10581,GC 210101,NA,NA,NA,-Split-,NA,2310,88842.1
,,,1/1/2021,Journal Entry,10581,GC 210101,NA,NA,NA,-Split-,NA,4150,92992.1
,,,1/1/2021,Journal Entry,10581,GC 210101,NA,NA,NA,-Split-,NA,1300,94292.1
,,,1/1/2021,Journal Entry,10581,GC 210101,NA,NA,NA,-Split-,NA,1672,95964.1
,,,1/1/2021,Journal Entry,10581,GC 210101,NA,NA,NA,-Split-,NA,864,96828.1
,,,1/1/2021,Journal Entry,10581,GC 210101,NA,NA,NA,-Split-,NA,4184,101012.1
,,,1/1/2021,Journal Entry,10581,GC 210101,NA,NA,NA,-Split-,NA,671,101683.1
,,,1/1/2021,Journal Entry,10581,GC 210101,NA,NA,NA,-Split-,NA,1581,103264.1
,,,1/1/2021,Journal Entry,10581,GC 210101,NA,NA,NA,-Split-,NA,449.5,103713.6
,,,1/1/2021,Journal Entry,10581,GC 210101,NA,NA,NA,-Split-,NA,2015,105728.6
,,,1/1/2021,Journal Entry,10581,GC 210101,NA,NA,NA,-Split-,NA,380,106108.6
,,,1/1/2021,Journal Entry,10581,GC 210101,NA,NA,NA,-Split-,NA,1435,107543.6
,,,1/1/2021,Journal Entry,10581,GC 210101,NA,NA,NA,-Split-,NA,1893.33,109436.93
,,,1/1/2021,Journal Entry,10581,GC 210101,NA,NA,NA,-Split-,NA,345,109781.93
,,,1/1/2021,Journal Entry,10581,GC 210101,NA,NA,NA,-Split-,NA,525,110306.93
,,,1/1/2021,Journal Entry,10581,GC 210101,NA,NA,NA,-Split-,NA,5910,116216.93
,,,1/1/2021,Journal Entry,10581,GC 210101,NA,NA,NA,-Split-,NA,750,116966.93
,,,1/1/2021,Journal Entry,10581,GC 210101,NA,NA,NA,-Split-,NA,1060,118026.93
,,,1/1/2021,Journal Entry,10581,GC 210101,NA,NA,NA,-Split-,NA,7815,125841.93
,,,1/1/2021,Journal Entry,10581,GC 210101,NA,NA,NA,-Split-,NA,700,126541.93
,,,1/1/2021,Journal Entry,10581,GC 210101,NA,NA,NA,-Split-,NA,3180,129721.93
,,,1/1/2021,Journal Entry,10581,GC 210101,NA,NA,NA,-Split-,NA,350,130071.93
,,,1/1/2021,Journal Entry,10581,GC 210101,NA,NA,NA,-Split-,NA,1165,131236.93
,,,1/1/2021,Journal Entry,10581,GC 210101,NA,NA,NA,-Split-,NA,65,131301.93
,,,1/1/2021,Journal Entry,10581,GC 210101,NA,NA,NA,-Split-,NA,245,131546.93
,,,1/1/2021,Journal Entry,10581,GC 210101,NA,NA,NA,-Split-,NA,7384,138930.93
,,,1/1/2021,Journal Entry,10581,GC 210101,NA,NA,NA,-Split-,NA,1024.25,139955.18
,,,1/1/2021,Journal Entry,10581,GC 210101,NA,NA,NA,-Split-,NA,1239.5,141194.68
,,,1/1/2021,Journal Entry,10581,GC 210101,NA,NA,NA,-Split-,NA,889.5,142084.18
,,,1/1/2021,Journal Entry,10581,GC 210101,NA,NA,NA,-Split-,NA,420,142504.18
,,,1/1/2021,Journal Entry,10581,GC 210101,NA,NA,NA,-Split-,NA,6330,148834.18
,,,1/1/2021,Journal Entry,10581,GC 210101,NA,NA,NA,-Split-,NA,1840,150674.18
,,,1/1/2021,Journal Entry,10581,GC 210101,NA,NA,NA,-Split-,NA,60,150734.18
,,,1/1/2021,Journal Entry,10581,GC 210101,NA,NA,NA,-Split-,NA,2285,153019.18
,,,1/1/2021,Journal Entry,10581,GC 210101,NA,NA,NA,-Split-,NA,380,153399.18
,,,1/1/2021,Journal Entry,10581,GC 210101,NA,NA,NA,-Split-,NA,360,153759.18
,,,1/1/2021,Journal Entry,10581,GC 210101,NA,NA,NA,-Split-,NA,5160,158919.18
,,,1/1/2021,Journal Entry,10581,GC 210101,NA,NA,NA,-Split-,NA,350,159269.18
,,,1/1/2021,Journal Entry,10581,GC 210101,NA,NA,NA,-Split-,NA,1495,160764.18
,,,1/1/2021,Journal Entry,10581,GC 210101,NA,NA,NA,-Split-,NA,3412,164176.18
,,,1/1/2021,Journal Entry,10581,GC 210101,NA,NA,NA,-Split-,NA,590,164766.18
,,,1/1/2021,Journal Entry,10581,GC 210101,NA,NA,NA,-Split-,NA,3725,168491.18
,,,1/1/2021,Journal Entry,10581,GC 210101,NA,NA,NA,-Split-,NA,450,168941.18
,,,1/1/2021,Journal Entry,10581,GC 210101,NA,NA,NA,-Split-,NA,1495,170436.18
,,,1/1/2021,Journal Entry,10581,GC 210101,NA,NA,NA,-Split-,NA,750,171186.18
,,,1/1/2021,Journal Entry,10581,GC 210101,NA,NA,NA,-Split-,NA,2002.25,173188.43
,,,1/1/2021,Journal Entry,10581,GC 210101,NA,NA,NA,-Split-,NA,584.5,173772.93
,,,1/1/2021,Journal Entry,10581,GC 210101,NA,NA,NA,-Split-,NA,4742,178514.93
,,,1/1/2021,Journal Entry,10581,GC 210101,NA,NA,NA,-Split-,NA,757,179271.93
,,,1/1/2021,Journal Entry,10581,GC 210101,NA,NA,NA,-Split-,NA,342,179613.93
,,,1/1/2021,Journal Entry,10581,GC 210101,NA,NA,NA,-Split-,NA,2295,181908.93
,,,1/1/2021,Journal Entry,10581,GC 210101,NA,NA,NA,-Split-,NA,690,182598.93
,,,1/1/2021,Journal Entry,10581,GC 210101,NA,NA,NA,-Split-,NA,560,183158.93
,,,1/1/2021,Journal Entry,10581,GC 210101,NA,NA,NA,-Split-,NA,4068.5,187227.43
,,,1/1/2021,Journal Entry,10581,GC 210101,NA,NA,NA,-Split-,NA,700,187927.43
,,,1/1/2021,Journal Entry,10581,GC 210101,NA,NA,NA,-Split-,NA,978,188905.43
,,,1/1/2021,Journal Entry,10581,GC 210101,NA,NA,NA,-Split-,NA,2780,191685.43
,,,1/1/2021,Journal Entry,10581,GC 210101,NA,NA,NA,-Split-,NA,552,192237.43
,,,1/1/2021,Journal Entry,10581,GC 210101,NA,NA,NA,-Split-,NA,1069,193306.43
,,,1/1/2021,Journal Entry,10581,GC 210101,NA,NA,NA,-Split-,NA,3280,196586.43
,,,1/3/2021,Journal Entry,10570,SUN 210103,NA,NA,NA,-Split-,NA,-17473.05,179113.38
,,,1/3/2021,Journal Entry,10570,SUN 210103,NA,NA,NA,-Split-,NA,17473.05,196586.43
,,,1/3/2021,Journal Entry,10570,SUN 210103,NA,NA,NA,-Split-,NA,16434.05,213020.48
,,,1/4/2021,Deposit,4443,NA,NA,NA,MD CHRISTMAS 210104,3020 Christmas Collection,110,22417,235437.48
,,,1/4/2021,Check,8973,ACH,bank Fee,346,NA,4158 Administrative Expenses:Bank Fees,386,-7078.39,228359.09
,,,1/5/2021,Check,8974,ACH,First Fund,340,NA,4158 Administrative Expenses:Bank Fees,386,-333.93,228025.16
,,,1/5/2021,Deposit,4442,NA,NA,NA,MD Christmas 210105,3020 Christmas Collection,110,7500,235525.16
,,,1/5/2021,Deposit,4173,NA,NA,NA,Smart210105 SJS,-Split-,NA,1096.01,236621.17
,,,1/5/2021,Deposit,4167,NA,NA,NA,Smart 210105 SFX,-Split-,NA,2336.88,238958.05
,,,1/6/2021,Check,8975,ACH,Stop Payment,358,NA,4158 Administrative Expenses:Bank Fees,386,-100,238858.05
,,,1/7/2021,Check,8976,ach,acct adjustment,366,NA,4158 Administrative Expenses:Bank Fees,386,-118,238740.05
,,,1/7/2021,Journal Entry,10586,210107 MD,NA,NA,NA,-Split-,NA,23240,261980.05
,,,1/7/2021,Journal Entry,10586,210107 MD,NA,NA,NA,-Split-,NA,13180,275160.05
,,,1/7/2021,Journal Entry,10586,210107 MD,NA,NA,NA,-Split-,NA,-23240,251920.05
,,,1/8/2021,Journal Entry,10565,PP01082021,NA,NA,Direct Deposits,-Split-,NA,-81091,170829.05
,,,1/8/2021,Deposit,4168,NA,NA,NA,Smart210108 SFXS,-Split-,NA,7521.41,178350.46
,,,1/8/2021,Journal Entry,10565,PP01082021,NA,NA,403B,-Split-,NA,-5949.14,172401.32
,,,1/8/2021,Journal Entry,10565,PP01082021,NA,NA,Life Ins,-Split-,NA,-321.73,172079.59
,,,1/8/2021,Journal Entry,10565,PP01082021,NA,NA,STD,-Split-,NA,-61.2,172018.39
,,,1/8/2021,Journal Entry,10565,PP01082021,NA,NA,Flex,-Split-,NA,-365,171653.39
,,,1/8/2021,Journal Entry,10565,PP01082021,NA,NA,94296,-Split-,NA,-1565.62,170087.77
,,,1/8/2021,Journal Entry,10565,PP01082021,NA,NA,94297,-Split-,NA,-1102.28,168985.49
,,,1/8/2021,Journal Entry,10565,PP01082021,NA,NA,94298,-Split-,NA,-738.5,168246.99
,,,1/8/2021,Journal Entry,10565,PP01082021,NA,NA,94299,-Split-,NA,-87.4,168159.59
,,,1/8/2021,Journal Entry,10565,PP01082021,NA,NA,94300,-Split-,NA,-190.37,167969.22
,,,1/8/2021,Journal Entry,10565,PP01082021,NA,NA,94301,-Split-,NA,-643.54,167325.68
,,,1/8/2021,Journal Entry,10565,PP01082021,NA,NA,IOI Fee,-Split-,NA,-142.1,167183.58
,,,1/8/2021,Journal Entry,10563,PP01082021,NA,NA,Direct Deposits,-Split-,NA,-18505.47,148678.11
,,,1/8/2021,Journal Entry,10563,PP01082021,NA,NA,Taxes,-Split-,NA,-6336.1,142342.01
,,,1/8/2021,Journal Entry,10563,PP01082021,NA,NA,403B,-Split-,NA,-2935.77,139406.24
,,,1/8/2021,Journal Entry,10563,PP01082021,NA,NA,Life Ins,-Split-,NA,-159.14,139247.1
,,,1/8/2021,Journal Entry,10563,PP01082021,NA,NA,STD,-Split-,NA,-6.5,139240.6
,,,1/8/2021,Journal Entry,10563,PP01082021,NA,NA,Flex,-Split-,NA,-330,138910.6
,,,1/8/2021,Journal Entry,10563,PP01082021,NA,NA,PRMAA,-Split-,NA,-50,138860.6
,,,1/8/2021,Journal Entry,10563,PP01082021,NA,NA,11975-VOID,-Split-,NA,0,138860.6
,,,1/8/2021,Journal Entry,10563,PP01082021,NA,NA,IOI Fee,-Split-,NA,-58.31,138802.29
,,,1/8/2021,Journal Entry,10565,PP01082021,NA,NA,Taxes,-Split-,NA,-29048.42,109753.87
,,,1/10/2021,Journal Entry,10572,SPEC 210110,NA,NA,NA,-Split-,NA,-6336.66,103417.21
,,,1/10/2021,Journal Entry,10572,SPEC 210110,NA,NA,NA,-Split-,NA,4811.66,108228.87
,,,1/10/2021,Journal Entry,10572,SPEC 210110,NA,NA,NA,-Split-,NA,6336.66,114565.53
,,,1/10/2021,Deposit,4162,NA,NA,NA,SUN 210110,3012 Sunday and Holy Day Collections:Sunday Collection:Sunday Collection Envelopes,278,10715,125280.53
,,,1/10/2021,Journal Entry,10573,SUN 200110,NA,NA,NA,-Split-,NA,0,125280.53
,,,1/10/2021,Journal Entry,10573,SUN 200110,NA,NA,NA,-Split-,NA,1390,126670.53
,,,1/10/2021,Journal Entry,10573,SUN 200110,NA,NA,NA,-Split-,NA,-1390,125280.53
,,,1/12/2021,Journal Entry,10574,MD 210112,NA,NA,NA,-Split-,NA,-6780,118500.53
,,,1/12/2021,Deposit,4444,NA,NA,NA,acct adj credit,3013.1 Sunday and Holy Day Collections:Sunday Collection:Sunday Collection Loose Ck/Cash:Counting Error,692,250,118750.53
,,,1/12/2021,Journal Entry,10574,MD 210112,NA,NA,NA,-Split-,NA,6780,125530.53
,,,1/12/2021,Journal Entry,10574,MD 210112,NA,NA,NA,-Split-,NA,1080,126610.53
,,,1/13/2021,Bill Payment (Check),2785,3916,Daniel Mayall,85,NA,2000 Accounts Payable,217,-63,126547.53
,,,1/13/2021,Bill Payment (Check),2786,3917,Edward Harnett,121,NA,2000 Accounts Payable,217,-400,126147.53
,,,1/13/2021,Bill Payment (Check),2787,3918,Eileen and Kevin O'Hara,874,NA,2000 Accounts Payable,217,-800,125347.53
,,,1/13/2021,Bill Payment (Check),2788,3919,Elk Grove Graphics,485,NA,2000 Accounts Payable,217,-991.98,124355.55
,,,1/13/2021,Bill Payment (Check),2789,3920,Engie Resources Convent SJ,112,NA,2000 Accounts Payable,217,-133.56,124221.99
,,,1/13/2021,Bill Payment (Check),2790,3921,Engie Resources SJ Campus,111,NA,2000 Accounts Payable,217,-1918.53,122303.46
,,,1/13/2021,Bill Payment (Check),2791,3922,Engie SFX,253,NA,2000 Accounts Payable,217,-276.69,122026.77
,,,1/13/2021,Bill Payment (Check),2792,3923,GO Technology Group Inc.,64,NA,2000 Accounts Payable,217,-6945,115081.77
,,,1/13/2021,Bill Payment (Check),2793,3924,Janina Jakucewicz,138,NA,2000 Accounts Payable,217,-229.08,114852.69
,,,1/13/2021,Bill Payment (Check),2794,3925,"Kranz, Inc",415,NA,2000 Accounts Payable,217,-355.44,114497.25
,,,1/13/2021,Bill Payment (Check),2795,3926,Lapels of WIlmette SFX Rectory Cleaning,58,NA,2000 Accounts Payable,217,-24,114473.25
,,,1/13/2021,Bill Payment (Check),2796,3927,Lapels of Wilmette SJC,426,NA,2000 Accounts Payable,217,-60,114413.25
,,,1/13/2021,Bill Payment (Check),2797,3928,Learning Without Tears,404,NA,2000 Accounts Payable,217,-22.7,114390.55
,,,1/13/2021,Bill Payment (Check),2798,3929,Metropolitan Water Reclamation District,518,NA,2000 Accounts Payable,217,-998.89,113391.66
,,,1/13/2021,Bill Payment (Check),2799,3930,Monk's WIne and Candles SSJFX,65,NA,2000 Accounts Payable,217,-276.06,113115.6
,,,1/13/2021,Bill Payment (Check),2800,3931,Morning Glory Flower Shop,55,NA,2000 Accounts Payable,217,-89,113026.6
,,,1/13/2021,Bill Payment (Check),2801,3932,Nicor SJ Convent,12,NA,2000 Accounts Payable,217,-907.46,112119.14
,,,1/13/2021,Bill Payment (Check),2802,3933,Pitney Bowes Purchase Power SFXCH 6704,806,NA,2000 Accounts Payable,217,-534.85,111584.29
,,,1/13/2021,Bill Payment (Check),2803,3934,Ron's Artic Snowplowing,304,NA,2000 Accounts Payable,217,-6341.25,105243.04
,,,1/13/2021,Bill Payment (Check),2804,3935,St. Joan of Arc,870,NA,2000 Accounts Payable,217,-1263.58,103979.46
,,,1/13/2021,Bill Payment (Check),2805,3936,Staples SJ,92,NA,2000 Accounts Payable,217,-1431.46,102548
,,,1/13/2021,Bill Payment (Check),2806,3937,TelAssist,137,NA,2000 Accounts Payable,217,-94.92,102453.08
,,,1/13/2021,Bill Payment (Check),2807,3938,The New York Times,140,NA,2000 Accounts Payable,217,-54,102399.08
,,,1/13/2021,Bill Payment (Check),2808,3939,Verizon Wireless,118,NA,2000 Accounts Payable,217,-88.1,102310.98
,,,1/13/2021,Bill Payment (Check),2809,3940,Village of Wilmette SJ Annex 330900,830,NA,2000 Accounts Payable,217,-820.5,101490.48
,,,1/13/2021,Bill Payment (Check),2810,3941,Watra Church Goods,350,NA,2000 Accounts Payable,217,-11.5,101478.98
,,,1/13/2021,Bill Payment (Check),2811,3942,Wayne Watts,241,NA,2000 Accounts Payable,217,-6095.84,95383.14
,,,1/13/2021,Bill Payment (Check),2812,3943,Wilshore Electric LLC,872,NA,2000 Accounts Payable,217,-2384,92999.14
,,,1/13/2021,Bill Payment (Check),2813,3944,James Bui,873,NA,2000 Accounts Payable,217,-200,92799.14
,,,1/13/2021,Bill Payment (Check),2814,3945,John Hopkins,101,NA,2000 Accounts Payable,217,-257.26,92541.88
,,,1/13/2021,Bill Payment (Check),2815,3946,Joseph D'Arco,45,NA,2000 Accounts Payable,217,-360,92181.88
,,,1/13/2021,Bill Payment (Check),2816,3947,Merbeth Metal Products Inc,866,NA,2000 Accounts Payable,217,-580,91601.88
,,,1/13/2021,Bill Payment (Check),2817,3948,Mike Henn,79,NA,2000 Accounts Payable,217,-2090.5,89511.38
,,,1/13/2021,Bill Payment (Check),2818,3949,Precision,93,NA,2000 Accounts Payable,217,-1867,87644.38
,,,1/13/2021,Bill Payment (Check),2761,3892,A SmartSign Store,567,NA,2000 Accounts Payable,217,-635.36,87009.02
,,,1/13/2021,Bill Payment (Check),2762,3893,Accurate Biometrics,24,NA,2000 Accounts Payable,217,-46.5,86962.52
,,,1/13/2021,Bill Payment (Check),2763,3894,Advanced Disposal SFX CH,59,NA,2000 Accounts Payable,217,-157.05,86805.47
,,,1/13/2021,Bill Payment (Check),2764,3895,Advanced Disposal SFX Sch,60,NA,2000 Accounts Payable,217,-457.03,86348.44
,,,1/13/2021,Bill Payment (Check),2765,3896,Advanced Disposal SJ CH,108,NA,2000 Accounts Payable,217,-429.81,85918.63
,,,1/13/2021,Bill Payment (Check),2766,3897,Americhoice Radon Testing,869,NA,2000 Accounts Payable,217,-500,85418.63
,,,1/13/2021,Bill Payment (Check),2767,3898,Anderson Lock,185,NA,2000 Accounts Payable,217,-16.36,85402.27
,,,1/13/2021,Bill Payment (Check),2768,3899,Apple Inc.,846,NA,2000 Accounts Payable,217,-5310,80092.27
,,,1/13/2021,Bill Payment (Check),2769,3900,AT&T Messaging SFX CH,71,NA,2000 Accounts Payable,217,-14.95,80077.32
,,,1/13/2021,Bill Payment (Check),2770,3901,AT&T SFX ALL 5570 631,169,NA,2000 Accounts Payable,217,-798.92,79278.4
,,,1/13/2021,Bill Payment (Check),2771,3902,AT&T SJC 395,25,NA,2000 Accounts Payable,217,-93.78,79184.62
,,,1/13/2021,Bill Payment (Check),2772,3903,AT&T SJC YFF 2253,448,NA,2000 Accounts Payable,217,-74.62,79110
,,,1/13/2021,Bill Payment (Check),2773,3904,AT&T SJS,235,NA,2000 Accounts Payable,217,-163.62,78946.38
,,,1/13/2021,Bill Payment (Check),2774,3905,Bank of America SFX 5830,296,NA,2000 Accounts Payable,217,-4815.28,74131.1
,,,1/13/2021,Bill Payment (Check),2775,3906,Bonnie Mootry,871,NA,2000 Accounts Payable,217,-100,74031.1
,,,1/13/2021,Bill Payment (Check),2776,3907,Canon,258,NA,2000 Accounts Payable,217,-1522,72509.1
,,,1/13/2021,Bill Payment (Check),2777,3908,Canon Maintanence,563,NA,2000 Accounts Payable,217,-108.6,72400.5
,,,1/13/2021,Bill Payment (Check),2778,3909,Canon SFX,524,contract 0010491764245,2000 Accounts Payable,217,-234,72166.5
,,,1/13/2021,Bill Payment (Check),2779,3910,Catholic Bishop of Chicago (BillingSFXS),548,NA,2000 Accounts Payable,217,-53662.44,18504.06
,,,1/13/2021,Bill Payment (Check),2780,3911,Catholic Bishop of Chicago (BillingSSJFX),359,NA,2000 Accounts Payable,217,-48032.36,-29528.3
,,,1/13/2021,Bill Payment (Check),2781,3912,Chicago Tribune,222,acct: 30043892,2000 Accounts Payable,217,-139.16,-29667.46
,,,1/13/2021,Bill Payment (Check),2782,3913,Comcast Business (Internet) SJS 5239,851,NA,2000 Accounts Payable,217,-293.35,-29960.81
,,,1/13/2021,Bill Payment (Check),2783,3914,Comcast SFX Rectory 2307,170,NA,2000 Accounts Payable,217,-232.75,-30193.56
,,,1/13/2021,Bill Payment (Check),2784,3915,Comcast Business (TV) SFXS 1576,57,NA,2000 Accounts Payable,217,-5.04,-30198.6
,,,1/15/2021,Deposit,4174,NA,NA,NA,Smart 210115 SJS,-Split-,NA,40499.12,10300.52
,,,1/15/2021,Deposit,4169,NA,NA,NA,Smart210115 SFXS,-Split-,NA,117268.64,127569.16
,,,1/17/2021,Journal Entry,10575,SUN 210117,NA,NA,NA,-Split-,NA,9203,136772.16
,,,1/17/2021,Journal Entry,10575,SUN 210117,NA,NA,NA,-Split-,NA,7607,144379.16
,,,1/17/2021,Journal Entry,10575,SUN 210117,NA,NA,NA,-Split-,NA,-9203,135176.16
,,,1/18/2021,Journal Entry,10576,MD 210118,NA,NA,NA,-Split-,NA,-17891.5,117284.66
,,,1/18/2021,Journal Entry,10576,MD 210118,NA,NA,NA,-Split-,NA,17891.5,135176.16
,,,1/18/2021,Journal Entry,10576,MD 210118,NA,NA,NA,-Split-,NA,16391.5,151567.66
,,,1/19/2021,Deposit,4445,NA,NA,NA,UW Metro,3014 Sunday and Holy Day Collections:Sunday Collection:Sunday Collections E-Giving,406,160.01,151727.67
,,,1/19/2021,Check,8977,ACH,Analysis activity,824,NA,4158 Administrative Expenses:Bank Fees,386,-289.66,151438.01
,,,1/20/2021,Deposit,4175,NA,NA,NA,Smart 210120 SJS,-Split-,NA,2009,153447.01
,,,1/20/2021,Deposit,4170,NA,NA,NA,Smart210120 SFXS,-Split-,NA,46823.68,200270.69
,,,1/22/2021,Journal Entry,10564,PP01222021,NA,NA,Direct Deposits,-Split-,NA,-20792.38,179478.31
,,,1/22/2021,Bill Payment (Check),2699,3952,Jennifer Henik,876,Fed8.31/Med3.39/SS14.51/IL11.58/Gross234.00,2000 Accounts Payable,217,-196.31,179282
,,,1/22/2021,Journal Entry,10564,PP01222021,NA,NA,403B,-Split-,NA,-3080.33,176201.67
,,,1/22/2021,Journal Entry,10564,PP01222021,NA,NA,Medical/Dental Sweep,-Split-,NA,-5013,171188.67
,,,1/22/2021,Journal Entry,10564,PP01222021,NA,NA,Life Ins,-Split-,NA,-159.14,171029.53
,,,1/22/2021,Journal Entry,10564,PP01222021,NA,NA,STD,-Split-,NA,-6.5,171023.03
,,,1/22/2021,Journal Entry,10564,PP01222021,NA,NA,Flex,-Split-,NA,-330,170693.03
,,,1/22/2021,Journal Entry,10564,PP01222021,NA,NA,PRMAA,-Split-,NA,-50,170643.03
,,,1/22/2021,Journal Entry,10564,PP01222021,NA,NA,11976,-Split-,NA,-766.97,169876.06
,,,1/22/2021,Journal Entry,10564,PP01222021,NA,NA,11977,-Split-,NA,-549.81,169326.25
,,,1/22/2021,Journal Entry,10564,PP01222021,NA,NA,IOI Fee,-Split-,NA,-52.19,169274.06
,,,1/22/2021,Journal Entry,10567,PP01222021,NA,NA,Direct Deposits,-Split-,NA,-93207.75,76066.31
,,,1/22/2021,Journal Entry,10567,PP01222021,NA,NA,Taxes,-Split-,NA,-33412.34,42653.97
,,,1/22/2021,Journal Entry,10567,PP01222021,NA,NA,403B,-Split-,NA,-6347.87,36306.1
,,,1/22/2021,Journal Entry,10567,PP01222021,NA,NA,Medical/Dental Sweep,-Split-,NA,-14714.5,21591.6
,,,1/22/2021,Journal Entry,10567,PP01222021,NA,NA,Life Ins,-Split-,NA,-321.73,21269.87
,,,1/22/2021,Journal Entry,10567,PP01222021,NA,NA,STD,-Split-,NA,-61.2,21208.67
,,,1/22/2021,Journal Entry,10567,PP01222021,NA,NA,Flex,-Split-,NA,-365,20843.67
,,,1/22/2021,Journal Entry,10567,PP01222021,NA,NA,94302,-Split-,NA,-1722.39,19121.28
,,,1/22/2021,Journal Entry,10567,PP01222021,NA,NA,94303,-Split-,NA,-1204.98,17916.3
,,,1/22/2021,Journal Entry,10567,PP01222021,NA,NA,94304,-Split-,NA,-138.5,17777.8
,,,1/22/2021,Journal Entry,10567,PP01222021,NA,NA,94305,-Split-,NA,-580.39,17197.41
,,,1/22/2021,Journal Entry,10567,PP01222021,NA,NA,94306,-Split-,NA,-748.03,16449.38
,,,1/22/2021,Journal Entry,10567,PP01222021,NA,NA,94307,-Split-,NA,-69.65,16379.73
,,,1/22/2021,Journal Entry,10567,PP01222021,NA,NA,94308,-Split-,NA,-135.98,16243.75
,,,1/22/2021,Journal Entry,10567,PP01222021,NA,NA,94309,-Split-,NA,-254.43,15989.32
,,,1/22/2021,Journal Entry,10567,PP01222021,NA,NA,IOI Fee,-Split-,NA,-166.4,15822.92
,,,1/22/2021,Journal Entry,10577,MD 210122,NA,NA,NA,-Split-,NA,-7520,8302.92
,,,1/22/2021,Journal Entry,10577,MD 210122,NA,NA,NA,-Split-,NA,6520,14822.92
,,,1/22/2021,Journal Entry,10577,MD 210122,NA,NA,NA,-Split-,NA,7520,22342.92
,,,1/22/2021,Deposit,4163,NA,NA,NA,MOC 210122,3720 Miscellaneous Income:Other Miscellaneous Income,312,495,22837.92
,,,1/22/2021,Journal Entry,10564,PP01222021,NA,NA,Taxes,-Split-,NA,-7536.61,15301.31
,,,1/24/2021,Journal Entry,10578,SUN 210124,NA,NA,NA,-Split-,NA,-8193,7108.31
,,,1/24/2021,Journal Entry,10578,SUN 210124,NA,NA,NA,-Split-,NA,8193,15301.31
,,,1/24/2021,Journal Entry,10578,SUN 210124,NA,NA,NA,-Split-,NA,7468,22769.31
,,,1/25/2021,Deposit,4171,NA,NA,NA,Smart210125 SFXS,-Split-,NA,258390.35,281159.66
,,,1/25/2021,Deposit,4176,NA,NA,NA,Smart 210125 SJS,-Split-,NA,17062.85,298222.51
,,,1/25/2021,Deposit,4172,NA,NA,NA,Deposit,3101 Tuition:Tuition - Current,698,40,298262.51
,,,1/27/2021,Bill Payment (Check),2821,3982,Martin Peterson Company Inc.,353,NA,2000 Accounts Payable,217,-11190,287072.51
,,,1/27/2021,Deposit,4440,NA,NA,NA,Deposit,3703 Miscellaneous Income:Votive and Vigil Candles,157,514.68,287587.19
,,,1/27/2021,Bill Payment (Check),2823,3984,Ministry Against the Death Penalty,817,NA,2000 Accounts Payable,217,-250,287337.19
,,,1/27/2021,Bill Payment (Check),2824,3985,OCP,475,NA,2000 Accounts Payable,217,-283.32,287053.87
,,,1/27/2021,Bill Payment (Check),2825,3986,Pamela Elliot,880,NA,2000 Accounts Payable,217,-139,286914.87
,,,1/27/2021,Bill Payment (Check),2826,3987,Ron's Artic Snowplowing,304,NA,2000 Accounts Payable,217,-6341.25,280573.62
,,,1/27/2021,Bill Payment (Check),2827,3988,"Savvas Learning Company, LLC",832,NA,2000 Accounts Payable,217,-1490.61,279083.01
,,,1/27/2021,Bill Payment (Check),2828,3989,"Schaefer's Wines, Foods & Spirits",56,NA,2000 Accounts Payable,217,-880.84,278202.17
,,,1/27/2021,Bill Payment (Check),2829,3990,Sparks Interior LTD,877,NA,2000 Accounts Payable,217,-899,277303.17
,,,1/27/2021,Bill Payment (Check),2830,3991,TelAssist,137,NA,2000 Accounts Payable,217,-99.34,277203.83
,,,1/27/2021,Bill Payment (Check),2831,3992,The Catholic Bishop of Chicago,230,NA,2000 Accounts Payable,217,-38.5,277165.33
,,,1/27/2021,Bill Payment (Check),2832,3993,The New York Times,140,NA,2000 Accounts Payable,217,-108,277057.33
,,,1/27/2021,Bill Payment (Check),2833,3994,Verizon Wireless,118,NA,2000 Accounts Payable,217,-93.25,276964.08
,,,1/27/2021,Bill Payment (Check),2709,3962,Bank of America SFX 5830,296,NA,2000 Accounts Payable,217,-7884.76,269079.32
,,,1/27/2021,Bill Payment (Check),2710,3963,Berghaus,270,NA,2000 Accounts Payable,217,-215.65,268863.67
,,,1/27/2021,Bill Payment (Check),2711,3964,Catholic Bishop of Chicago (BillingSJS),547,NA,2000 Accounts Payable,217,-13656.38,255207.29
,,,1/27/2021,Bill Payment (Check),2712,3965,Catholic Extension,879,NA,2000 Accounts Payable,217,-1000,254207.29
,,,1/27/2021,Bill Payment (Check),2713,3966,Church Budget,28,NA,2000 Accounts Payable,217,-601.18,253606.11
,,,1/27/2021,Bill Payment (Check),2714,3967,Claire Labuda,537,NA,2000 Accounts Payable,217,-500,253106.11
,,,1/27/2021,Bill Payment (Check),2715,3968,Comcast Business (Internet) SFXS 5692,850,NA,2000 Accounts Payable,217,-224.9,252881.21
,,,1/27/2021,Bill Payment (Check),2716,3969,Comcast SFX Office 2331,142,NA,2000 Accounts Payable,217,-130.61,252750.6
,,,1/27/2021,Bill Payment (Check),2717,3970,Crescent Cleaning Company,820,NA,2000 Accounts Payable,217,-28883.38,223867.22
,,,1/27/2021,Bill Payment (Check),2718,3971,Eileen Kirk,711,NA,2000 Accounts Payable,217,-195,223672.22
,,,1/27/2021,Bill Payment (Check),2719,3972,Engie SFX,253,NA,2000 Accounts Payable,217,-8695.25,214976.97
,,,1/27/2021,Bill Payment (Check),2720,3973,Fox Valley Fire and Safety,269,NA,2000 Accounts Payable,217,-337,214639.97
,,,1/27/2021,Bill Payment (Check),2721,3974,FP Mailing Solutions,114,NA,2000 Accounts Payable,217,-95.34,214544.63
,,,1/27/2021,Bill Payment (Check),2722,3975,"Fun Fluency, Inc",509,NA,2000 Accounts Payable,217,-6515,208029.63
,,,1/27/2021,Bill Payment (Check),2723,3976,Gospel Weeklies,237,NA,2000 Accounts Payable,217,-85.22,207944.41
,,,1/27/2021,Bill Payment (Check),2724,3977,Houghton Mifflin Harcourt,189,NA,2000 Accounts Payable,217,-2724.1,205220.31
,,,1/27/2021,Bill Payment (Check),2725,3978,Impressions In Stone,236,NA,2000 Accounts Payable,217,-177.9,205042.41
,,,1/27/2021,Bill Payment (Check),2726,3979,Jonathan Metzinger,438,NA,2000 Accounts Payable,217,-209.99,204832.42
,,,1/27/2021,Bill Payment (Check),2727,3980,Kit Kalpin,881,NA,2000 Accounts Payable,217,-22.5,204809.92
,,,1/27/2021,Bill Payment (Check),2728,3981,Loyola Press YFF,833,NA,2000 Accounts Payable,217,-3938.42,200871.5
,,,1/27/2021,Bill Payment (Check),2700,3953,"Active Electrical Supply Co., Inc",107,NA,2000 Accounts Payable,217,-21.48,200850.02
,,,1/27/2021,Bill Payment (Check),2701,3954,Albertsons/Safeway,156,NA,2000 Accounts Payable,217,-908.65,199941.37
,,,1/27/2021,Bill Payment (Check),2702,3955,Anderson Lock,185,NA,2000 Accounts Payable,217,-16.36,199925.01
,,,1/27/2021,Bill Payment (Check),2703,3956,Anderson Pest Solutions SFX,66,NA,2000 Accounts Payable,217,-79.83,199845.18
,,,1/27/2021,Bill Payment (Check),2704,3957,Anne Hrabe,878,NA,2000 Accounts Payable,217,-660,199185.18
,,,1/27/2021,Bill Payment (Check),2705,3958,AT&T SFX ALL 5570 631,169,NA,2000 Accounts Payable,217,-832.46,198352.72
,,,1/27/2021,Bill Payment (Check),2706,3959,AT&T SJC 395,25,NA,2000 Accounts Payable,217,-188.83,198163.89
,,,1/27/2021,Bill Payment (Check),2707,3960,AT&T SJS,235,NA,2000 Accounts Payable,217,-334.65,197829.24
,,,1/27/2021,Bill Payment (Check),2708,3961,Bank of America 4433,26,NA,2000 Accounts Payable,217,-7173.94,190655.3
,,,1/27/2021,Bill Payment (Check),2834,3995,Pitney Bowes SFXS 0015503825,488,NA,2000 Accounts Payable,217,-111.6,190543.7
,,,1/27/2021,Bill Payment (Check),2822,3983,Millen Hardware,155,NA,2000 Accounts Payable,217,-513.45,190030.25
,,,1/29/2021,Journal Entry,10585,wire transf,NA,NA,NA,-Split-,NA,-2349.75,187680.5
,,,1/29/2021,Bill Payment (Check),2836,3997,AT&T SJC YFF 2253,448,NA,2000 Accounts Payable,217,-70.93,187609.57
,,,1/29/2021,Deposit,4178,NA,NA,NA,Smart 210129 SJS,-Split-,NA,1305.54,188915.11
,,,1/29/2021,Deposit,4177,NA,NA,NA,Smart 210129 SFXS,-Split-,NA,42071.95,230987.06
,,,1/31/2021,Journal Entry,10582,SUNC 210131,NA,NA,NA,-Split-,NA,-21283,209704.06
,,,1/31/2021,Journal Entry,10582,SUNC 210131,NA,NA,NA,-Split-,NA,21283,230987.06
,,,1/31/2021,Journal Entry,10582,SUNC 210131,NA,NA,NA,-Split-,NA,19048,250035.06
,,,2/1/2021,Deposit,4463,NA,NA,NA,BEN,3014 Sunday and Holy Day Collections:Sunday Collection:Sunday Collections E-Giving,406,80,250115.06
,,,2/1/2021,Journal Entry,11028,GC FEB 2021,NA,NA,NA,-Split-,NA,-100,250015.06
,,,2/1/2021,Journal Entry,11028,GC FEB 2021,NA,NA,ASH,-Split-,NA,-1400,248615.06
,,,2/1/2021,Journal Entry,11028,GC FEB 2021,NA,NA,NA,-Split-,NA,-800,247815.06
,,,2/1/2021,Journal Entry,11028,GC FEB 2021,NA,NA,NA,-Split-,NA,-1445,246370.06
,,,2/1/2021,Journal Entry,11028,GC FEB 2021,NA,NA,NA,-Split-,NA,-15,246355.06
,,,2/1/2021,Journal Entry,11028,GC FEB 2021,NA,NA,NA,-Split-,NA,-275,246080.06
,,,2/1/2021,Journal Entry,11028,GC FEB 2021,NA,NA,NA,-Split-,NA,-165,245915.06
,,,2/1/2021,Journal Entry,11028,GC FEB 2021,NA,NA,capital projects,-Split-,NA,-15,245900.06
,,,2/1/2021,Journal Entry,11028,GC FEB 2021,NA,NA,NA,-Split-,NA,-360,245540.06
,,,2/1/2021,Journal Entry,11028,GC FEB 2021,NA,NA,NA,-Split-,NA,-1277,244263.06
,,,2/1/2021,Journal Entry,11028,GC FEB 2021,NA,NA,soup kitchen,-Split-,NA,-150,244113.06
,,,2/1/2021,Journal Entry,11028,GC FEB 2021,NA,NA,NA,-Split-,NA,-500,243613.06
,,,2/1/2021,Journal Entry,11028,GC FEB 2021,NA,NA,NA,-Split-,NA,3185,246798.06
,,,2/1/2021,Journal Entry,11028,GC FEB 2021,NA,NA,NA,-Split-,NA,402,247200.06
,,,2/1/2021,Journal Entry,11028,GC FEB 2021,NA,NA,NA,-Split-,NA,70,247270.06
,,,2/1/2021,Journal Entry,11028,GC FEB 2021,NA,NA,NA,-Split-,NA,1530,248800.06
,,,2/1/2021,Journal Entry,11028,GC FEB 2021,NA,NA,NA,-Split-,NA,100,248900.06
,,,2/1/2021,Journal Entry,11028,GC FEB 2021,NA,NA,NA,-Split-,NA,1823.33,250723.39
,,,2/1/2021,Journal Entry,11028,GC FEB 2021,NA,NA,NA,-Split-,NA,695,251418.39
,,,2/1/2021,Journal Entry,11028,GC FEB 2021,NA,NA,NA,-Split-,NA,1785,253203.39
,,,2/1/2021,Journal Entry,11028,GC FEB 2021,NA,NA,NA,-Split-,NA,400,253603.39
,,,2/1/2021,Journal Entry,11028,GC FEB 2021,NA,NA,NA,-Split-,NA,1810,255413.39
,,,2/1/2021,Journal Entry,11028,GC FEB 2021,NA,NA,NA,-Split-,NA,3839,259252.39
,,,2/1/2021,Journal Entry,11028,GC FEB 2021,NA,NA,NA,-Split-,NA,307,259559.39
,,,2/1/2021,Journal Entry,11028,GC FEB 2021,NA,NA,NA,-Split-,NA,1031,260590.39
,,,2/1/2021,Journal Entry,11028,GC FEB 2021,NA,NA,NA,-Split-,NA,1399.5,261989.89
,,,2/1/2021,Journal Entry,11028,GC FEB 2021,NA,NA,NA,-Split-,NA,6365,268354.89
,,,2/1/2021,Journal Entry,11028,GC FEB 2021,NA,NA,NA,-Split-,NA,1690,270044.89
,,,2/1/2021,Journal Entry,11028,GC FEB 2021,NA,NA,NA,-Split-,NA,360,270404.89
,,,2/1/2021,Journal Entry,11028,GC FEB 2021,NA,NA,NA,-Split-,NA,1375,271779.89
,,,2/1/2021,Journal Entry,11028,GC FEB 2021,NA,NA,NA,-Split-,NA,665,272444.89
,,,2/1/2021,Journal Entry,11028,GC FEB 2021,NA,NA,NA,-Split-,NA,710,273154.89
,,,2/1/2021,Journal Entry,11028,GC FEB 2021,NA,NA,NA,-Split-,NA,4535,277689.89
,,,2/1/2021,Journal Entry,11028,GC FEB 2021,NA,NA,NA,-Split-,NA,460,278149.89
,,,2/1/2021,Journal Entry,11028,GC FEB 2021,NA,NA,NA,-Split-,NA,812.5,278962.39
,,,2/1/2021,Journal Entry,11028,GC FEB 2021,NA,NA,NA,-Split-,NA,495,279457.39
,,,2/1/2021,Journal Entry,11028,GC FEB 2021,NA,NA,NA,-Split-,NA,1360,280817.39
,,,2/1/2021,Journal Entry,11028,GC FEB 2021,NA,NA,NA,-Split-,NA,300,281117.39
,,,2/1/2021,Journal Entry,11028,GC FEB 2021,NA,NA,NA,-Split-,NA,3300,284417.39
,,,2/1/2021,Journal Entry,11028,GC FEB 2021,NA,NA,NA,-Split-,NA,430,284847.39
,,,2/1/2021,Journal Entry,11028,GC FEB 2021,NA,NA,NA,-Split-,NA,2295,287142.39
,,,2/1/2021,Journal Entry,11028,GC FEB 2021,NA,NA,NA,-Split-,NA,1254.25,288396.64
,,,2/1/2021,Journal Entry,11028,GC FEB 2021,NA,NA,NA,-Split-,NA,1569.5,289966.14
,,,2/1/2021,Journal Entry,11028,GC FEB 2021,NA,NA,NA,-Split-,NA,3069,293035.14
,,,2/1/2021,Journal Entry,11028,GC FEB 2021,NA,NA,NA,-Split-,NA,902,293937.14
,,,2/1/2021,Journal Entry,11028,GC FEB 2021,NA,NA,NA,-Split-,NA,620,294557.14
,,,2/1/2021,Journal Entry,11028,GC FEB 2021,NA,NA,NA,-Split-,NA,2290,296847.14
,,,2/1/2021,Journal Entry,11028,GC FEB 2021,NA,NA,NA,-Split-,NA,690,297537.14
,,,2/1/2021,Journal Entry,11028,GC FEB 2021,NA,NA,NA,-Split-,NA,568,298105.14
,,,2/1/2021,Journal Entry,11028,GC FEB 2021,NA,NA,NA,-Split-,NA,1855,299960.14
,,,2/1/2021,Journal Entry,11028,GC FEB 2021,NA,NA,NA,-Split-,NA,750,300710.14
,,,2/1/2021,Journal Entry,11028,GC FEB 2021,NA,NA,NA,-Split-,NA,585,301295.14
,,,2/1/2021,Journal Entry,11028,GC FEB 2021,NA,NA,NA,-Split-,NA,1803,303098.14
,,,2/1/2021,Journal Entry,11028,GC FEB 2021,NA,NA,NA,-Split-,NA,370,303468.14
,,,2/1/2021,Journal Entry,11028,GC FEB 2021,NA,NA,NA,-Split-,NA,742,304210.14
,,,2/1/2021,Journal Entry,11028,GC FEB 2021,NA,NA,NA,-Split-,NA,3630,307840.14
,,,2/1/2021,Journal Entry,11028,GC FEB 2021,NA,NA,NA,-Split-,NA,2800,310640.14
,,,2/1/2021,Journal Entry,11028,GC FEB 2021,NA,NA,NA,-Split-,NA,2129.5,312769.64
,,,2/1/2021,Journal Entry,11028,GC FEB 2021,NA,NA,NA,-Split-,NA,700,313469.64
,,,2/1/2021,Journal Entry,11028,GC FEB 2021,NA,NA,NA,-Split-,NA,2120,315589.64
,,,2/1/2021,Journal Entry,11028,GC FEB 2021,NA,NA,NA,-Split-,NA,150,315739.64
,,,2/1/2021,Journal Entry,11028,GC FEB 2021,NA,NA,NA,-Split-,NA,1772.25,317511.89
,,,2/1/2021,Journal Entry,11028,GC FEB 2021,NA,NA,NA,-Split-,NA,1933.5,319445.39
,,,2/1/2021,Journal Entry,11028,GC FEB 2021,NA,NA,NA,-Split-,NA,3444,322889.39
,,,2/1/2021,Journal Entry,11028,GC FEB 2021,NA,NA,NA,-Split-,NA,-28,322861.39
,,,2/1/2021,Journal Entry,11028,GC FEB 2021,NA,NA,NA,-Split-,NA,575,323436.39
,,,2/1/2021,Journal Entry,11028,GC FEB 2021,NA,NA,NA,-Split-,NA,5043,328479.39
,,,2/1/2021,Journal Entry,11028,GC FEB 2021,NA,NA,NA,-Split-,NA,567,329046.39
,,,2/1/2021,Journal Entry,11028,GC FEB 2021,NA,NA,NA,-Split-,NA,2910,331956.39
,,,2/1/2021,Journal Entry,11028,GC FEB 2021,NA,NA,NA,-Split-,NA,1135,333091.39
,,,2/1/2021,Journal Entry,11028,GC FEB 2021,NA,NA,NA,-Split-,NA,50,333141.39
,,,2/1/2021,Journal Entry,11028,GC FEB 2021,NA,NA,NA,-Split-,NA,10,333151.39
,,,2/1/2021,Journal Entry,11028,GC FEB 2021,NA,NA,NA,-Split-,NA,1895,335046.39
,,,2/1/2021,Journal Entry,11028,GC FEB 2021,NA,NA,NA,-Split-,NA,-1000,334046.39
,,,2/1/2021,Journal Entry,11028,GC FEB 2021,NA,NA,NA,-Split-,NA,1145,335191.39
,,,2/1/2021,Journal Entry,11028,GC FEB 2021,NA,NA,NA,-Split-,NA,8062,343253.39
,,,2/1/2021,Journal Entry,11028,GC FEB 2021,NA,NA,NA,-Split-,NA,2150,345403.39
,,,2/1/2021,Journal Entry,11028,GC FEB 2021,NA,NA,NA,-Split-,NA,5675,351078.39
,,,2/1/2021,Journal Entry,11028,GC FEB 2021,NA,NA,NA,-Split-,NA,-335,350743.39
,,,2/1/2021,Journal Entry,11028,GC FEB 2021,NA,NA,NA,-Split-,NA,3615,354358.39
,,,2/1/2021,Journal Entry,11028,GC FEB 2021,NA,NA,NA,-Split-,NA,760,355118.39
,,,2/1/2021,Journal Entry,11028,GC FEB 2021,NA,NA,NA,-Split-,NA,13164,368282.39
,,,2/1/2021,Journal Entry,11028,GC FEB 2021,NA,NA,NA,-Split-,NA,5967,374249.39
,,,2/1/2021,Journal Entry,11028,GC FEB 2021,NA,NA,NA,-Split-,NA,2873.25,377122.64
,,,2/1/2021,Journal Entry,11028,GC FEB 2021,NA,NA,NA,-Split-,NA,1094.5,378217.14
,,,2/1/2021,Journal Entry,11028,GC FEB 2021,NA,NA,NA,-Split-,NA,5872,384089.14
,,,2/1/2021,Journal Entry,11028,GC FEB 2021,NA,NA,NA,-Split-,NA,2240,386329.14
,,,2/1/2021,Journal Entry,11028,GC FEB 2021,NA,NA,NA,-Split-,NA,675,387004.14
,,,2/1/2021,Journal Entry,11028,GC FEB 2021,NA,NA,NA,-Split-,NA,3077,390081.14
,,,2/1/2021,Journal Entry,11028,GC FEB 2021,NA,NA,NA,-Split-,NA,490,390571.14
,,,2/2/2021,Check,8981,ACH,Bank Card,341,NA,4158 Administrative Expenses:Bank Fees,386,-5003.68,385567.46
,,,2/2/2021,Check,8980,ACH,First Fund,340,NA,4158 Administrative Expenses:Bank Fees,386,-277,385290.46
,,,2/3/2021,Journal Entry,10583,MD 210203,NA,NA,NA,-Split-,NA,-38721.11,346569.35
,,,2/3/2021,Journal Entry,10583,MD 210203,NA,NA,NA,-Split-,NA,38721.11,385290.46
,,,2/3/2021,Journal Entry,10583,MD 210203,NA,NA,NA,-Split-,NA,31321.11,416611.57
,,,2/5/2021,Deposit,4465,NA,NA,NA,Smart 210205 SJS,3101 Tuition:Tuition - Current,698,370,416981.57
,,,2/5/2021,Journal Entry,10589,PP02192022,NA,NA,IOI Fee,-Split-,NA,-768.58,416212.99
,,,2/5/2021,Journal Entry,10587,PP02052021,NA,NA,Direct Deposits,-Split-,NA,-21897.22,394315.77
,,,2/5/2021,Journal Entry,10587,PP02052021,NA,NA,Taxes,-Split-,NA,-7828.25,386487.52
,,,2/5/2021,Journal Entry,10587,PP02052021,NA,NA,403B,-Split-,NA,-3158.97,383328.55
,,,2/5/2021,Journal Entry,10587,PP02052021,NA,NA,Life Ins,-Split-,NA,-159.14,383169.41
,,,2/5/2021,Journal Entry,10587,PP02052021,NA,NA,STD,-Split-,NA,-6.5,383162.91
,,,2/5/2021,Journal Entry,10587,PP02052021,NA,NA,Flex,-Split-,NA,-330,382832.91
,,,2/5/2021,Journal Entry,10587,PP02052021,NA,NA,PRMAA,-Split-,NA,-50,382782.91
,,,2/5/2021,Journal Entry,10587,PP02052021,NA,NA,11978,-Split-,NA,-762.84,382020.07
,,,2/5/2021,Journal Entry,10587,PP02052021,NA,NA,IOI Fee,-Split-,NA,-236.74,381783.33
,,,2/5/2021,Journal Entry,10589,PP02192022,NA,NA,Direct Deposits,-Split-,NA,-112474.78,269308.55
,,,2/5/2021,Journal Entry,10589,PP02192022,NA,NA,Taxes,-Split-,NA,-41706.19,227602.36
,,,2/5/2021,Journal Entry,10589,PP02192022,NA,NA,403B,-Split-,NA,-7424.61,220177.75
,,,2/5/2021,Journal Entry,10589,PP02192022,NA,NA,Life Ins,-Split-,NA,-321.73,219856.02
,,,2/5/2021,Journal Entry,10589,PP02192022,NA,NA,STD,-Split-,NA,-61.2,219794.82
,,,2/5/2021,Journal Entry,10589,PP02192022,NA,NA,Flex,-Split-,NA,-365,219429.82
,,,2/5/2021,Journal Entry,10589,PP02192022,NA,NA,94310,-Split-,NA,-1913.03,217516.79
,,,2/5/2021,Journal Entry,10589,PP02192022,NA,NA,94311,-Split-,NA,-1439.97,216076.82
,,,2/5/2021,Journal Entry,10589,PP02192022,NA,NA,94312,-Split-,NA,-513.5,215563.32
,,,2/5/2021,Journal Entry,10589,PP02192022,NA,NA,94313,-Split-,NA,-43.69,215519.63
,,,2/5/2021,Journal Entry,10589,PP02192022,NA,NA,94314,-Split-,NA,-805.58,214714.05
,,,2/5/2021,Journal Entry,10589,PP02192022,NA,NA,94315,-Split-,NA,-139.3,214574.75
,,,2/5/2021,Journal Entry,10589,PP02192022,NA,NA,94316,-Split-,NA,-392.47,214182.28
,,,2/5/2021,Journal Entry,10589,PP02192022,NA,NA,94317,-Split-,NA,-254.43,213927.85
,,,2/5/2021,Deposit,4466,NA,NA,NA,Smart 210205 SFXS,-Split-,NA,13894.03,227821.88
,,,2/7/2021,Journal Entry,10783,SUN 210207,NA,NA,NA,-Split-,NA,7334,235155.88
,,,2/7/2021,Journal Entry,10783,SUN 210207,NA,NA,NA,-Split-,NA,-8512,226643.88
,,,2/7/2021,Journal Entry,10783,SUN 210207,NA,NA,NA,-Split-,NA,8512,235155.88
,,,2/10/2021,Bill Payment (Check),2886,4007,Wayne Watts,241,Voided - VOID:,2000 Accounts Payable,217,0,235155.88
,,,2/10/2021,Deposit,4456,NA,NA,NA,Smart 210210 SFX,-Split-,NA,54334.55,289490.43
,,,2/10/2021,Bill Payment (Check),2888,4049,Altorfer Industries Inc,867,NA,2000 Accounts Payable,217,-11603,277887.43
,,,2/10/2021,Bill Payment (Check),2889,4050,"Kranz, Inc",415,NA,2000 Accounts Payable,217,-1959.97,275927.46
,,,2/10/2021,Bill Payment (Check),2890,4051,Millen Hardware,155,NA,2000 Accounts Payable,217,-363.78,275563.68
,,,2/10/2021,Bill Payment (Check),2891,4052,Village of Wilmette SFX CH 992100,225,NA,2000 Accounts Payable,217,-357.09,275206.59
,,,2/10/2021,Bill Payment (Check),2892,4053,Village of Wilmette SFX Conv 190780,227,NA,2000 Accounts Payable,217,-354.02,274852.57
,,,2/10/2021,Bill Payment (Check),2893,4054,Village of Wilmette SFX Rectory 201110,226,NA,2000 Accounts Payable,217,-700.05,274152.52
,,,2/10/2021,Bill Payment (Check),2894,4055,Wilshore Electric LLC,872,NA,2000 Accounts Payable,217,-1740,272412.52
,,,2/10/2021,Bill Payment (Check),2895,4056,AT&T Messaging SFX CH,71,NA,2000 Accounts Payable,217,-14.95,272397.57
,,,2/10/2021,Bill Payment (Check),2837,3998,Accurate Biometrics,24,NA,2000 Accounts Payable,217,-139.5,272258.07
,,,2/10/2021,Bill Payment (Check),2838,3999,Advanced Disposal SFX Sch,60,NA,2000 Accounts Payable,217,-457.03,271801.04
,,,2/10/2021,Bill Payment (Check),2839,4000,Advanced Disposal SJ CH,108,NA,2000 Accounts Payable,217,-429.81,271371.23
,,,2/10/2021,Bill Payment (Check),2840,4001,Anderson Lock,185,NA,2000 Accounts Payable,217,-114,271257.23
,,,2/10/2021,Bill Payment (Check),2841,4002,Canisius House Jesuit Community,450,NA,2000 Accounts Payable,217,-85,271172.23
,,,2/10/2021,Bill Payment (Check),2842,4003,Canon,258,NA,2000 Accounts Payable,217,-1522,269650.23
,,,2/10/2021,Bill Payment (Check),2843,4004,Canon Maintanence,563,NA,2000 Accounts Payable,217,-899.63,268750.6
,,,2/10/2021,Bill Payment (Check),2844,4005,Canon SFX,524,NA,2000 Accounts Payable,217,-234,268516.6
,,,2/10/2021,Bill Payment (Check),2845,4006,Chicago Tribune,222,NA,2000 Accounts Payable,217,-132,268384.6
,,,2/10/2021,Bill Payment (Check),2846,4008,Comcast SFX Rectory 2307,170,NA,2000 Accounts Payable,217,-238.05,268146.55
,,,2/10/2021,Bill Payment (Check),2847,4009,Constellation BG142404,128,NA,2000 Accounts Payable,217,-216.36,267930.19
,,,2/10/2021,Bill Payment (Check),2848,4010,Constellation BG91706,130,NA,2000 Accounts Payable,217,-189.62,267740.57
,,,2/10/2021,Bill Payment (Check),2849,4011,Constellation BG92628,90,NA,2000 Accounts Payable,217,-3747.87,263992.7
,,,2/10/2021,Bill Payment (Check),2850,4012,Constellation BG92634,91,NA,2000 Accounts Payable,217,-3105.34,260887.36
,,,2/10/2021,Bill Payment (Check),2851,4013,Crescent Cleaning Company,820,NA,2000 Accounts Payable,217,-17629.19,243258.17
,,,2/10/2021,Bill Payment (Check),2852,4014,Daniel Mayall,85,NA,2000 Accounts Payable,217,-147,243111.17
,,,2/10/2021,Bill Payment (Check),2853,4015,F.J. Kerrigan Plumbing Co. Inc,87,NA,2000 Accounts Payable,217,-7206.9,235904.27
,,,2/10/2021,Bill Payment (Check),2854,4016,GO Technology Group Inc.,64,NA,2000 Accounts Payable,217,-1784.5,234119.77
,,,2/10/2021,Bill Payment (Check),2855,4017,Home Depot Pro SFX,480,NA,2000 Accounts Payable,217,-687.6,233432.17
,,,2/10/2021,Bill Payment (Check),2856,4018,Integrity Systems,553,AMP replacement,2000 Accounts Payable,217,-469,232963.17
,,,2/10/2021,Bill Payment (Check),2857,4019,IPS Scripture School,362,NA,2000 Accounts Payable,217,-1500,231463.17
,,,2/10/2021,Bill Payment (Check),2858,4020,James Wallace,560,NA,2000 Accounts Payable,217,-300,231163.17
,,,2/10/2021,Bill Payment (Check),2859,4021,Jesuit Community of Loyola University,360,3 Jan masses,2000 Accounts Payable,217,-255,230908.17
,,,2/10/2021,Bill Payment (Check),2860,4022,John Hopkins,101,NA,2000 Accounts Payable,217,-36.44,230871.73
,,,2/10/2021,Bill Payment (Check),2861,4023,Johnson Controls Security Solutions SJS,588,NA,2000 Accounts Payable,217,-519.79,230351.94
,,,2/10/2021,Bill Payment (Check),2862,4024,Jonathan Metzinger,438,NA,2000 Accounts Payable,217,-100,230251.94
,,,2/10/2021,Bill Payment (Check),2863,4025,Joseph D'Arco,45,NA,2000 Accounts Payable,217,-1322.73,228929.21
,,,2/10/2021,Bill Payment (Check),2864,4026,Liguori Publications,585,NA,2000 Accounts Payable,217,-55,228874.21
,,,2/10/2021,Bill Payment (Check),2865,4027,Martin Peterson Company Inc.,353,NA,2000 Accounts Payable,217,-15160.51,213713.7
,,,2/10/2021,Bill Payment (Check),2866,4028,Monk's WIne and Candles SSJFX,65,NA,2000 Accounts Payable,217,-1210.6,212503.1
,,,2/10/2021,Bill Payment (Check),2867,4029,Nicor SJ Convent,12,NA,2000 Accounts Payable,217,-981.85,211521.25
,,,2/10/2021,Bill Payment (Check),2868,4030,North American,184,NA,2000 Accounts Payable,217,-666.21,210855.04
,,,2/10/2021,Bill Payment (Check),2869,4031,Pitney Bowes Purchase Power SFXCH 6704,806,NA,2000 Accounts Payable,217,-503.5,210351.54
,,,2/10/2021,Bill Payment (Check),2870,4032,Ron's Artic Snowplowing,304,NA,2000 Accounts Payable,217,-8141.25,202210.29
,,,2/10/2021,Bill Payment (Check),2871,4033,"S2Verify, LLC",94,NA,2000 Accounts Payable,217,-82.78,202127.51
,,,2/10/2021,Bill Payment (Check),2872,4034,Sara Crome,631,NA,2000 Accounts Payable,217,-9.05,202118.46
,,,2/10/2021,Bill Payment (Check),2873,4035,Sean McNamara,363,gross$486/Fed$0.33/Med$7.05/SS$30.13/IL$24.06,2000 Accounts Payable,217,-424.43,201694.03
,,,2/10/2021,Bill Payment (Check),2874,4036,Staples SJ,92,NA,2000 Accounts Payable,217,-429.99,201264.04
,,,2/10/2021,Bill Payment (Check),2875,4037,Terminix SJC,179,NA,2000 Accounts Payable,217,-94,201170.04
,,,2/10/2021,Bill Payment (Check),2876,4038,Terminix SJS,23,NA,2000 Accounts Payable,217,-73,201097.04
,,,2/10/2021,Bill Payment (Check),2877,4039,Tom Grenke,826,NA,2000 Accounts Payable,217,-25.62,201071.42
,,,2/10/2021,Bill Payment (Check),2878,4040,Wayne Watts,241,Voided - VOID:,2000 Accounts Payable,217,0,201071.42
,,,2/10/2021,Deposit,4454,NA,NA,NA,Smart 210210 SJS,-Split-,NA,8421.18,209492.6
,,,2/10/2021,Bill Payment (Check),2887,4048,Warehouse Direct SJ,82,NA,2000 Accounts Payable,217,-157.99,209334.61
,,,2/11/2021,Bill Payment (Check),2896,4057,Wayne Watts,241,NA,2000 Accounts Payable,217,-591.29,208743.32
,,,2/11/2021,Bill Payment (Check),2897,4058,Comcast Business (Internet) SJS 5239,851,NA,2000 Accounts Payable,217,-293.35,208449.97
,,,2/11/2021,Bill Payment (Check),2898,4059,Johnson Controls Security Solutions SJC,589,NA,2000 Accounts Payable,217,-892.69,207557.28
,,,2/11/2021,Bill Payment (Check),2899,4060,Johnson Controls Security Solutions SJS,588,NA,2000 Accounts Payable,217,-892.69,206664.59
,,,2/11/2021,Bill Payment (Check),2900,4061,Johnson Controls SJconvent 2639AD,460,NA,2000 Accounts Payable,217,-215.91,206448.68
,,,2/11/2021,Journal Entry,10796,SCH210211,NA,NA,NA,-Split-,NA,12045,218493.68
,,,2/11/2021,Journal Entry,11024,md210211,NA,NA,NA,-Split-,NA,5014.66,223508.34
,,,2/11/2021,Journal Entry,11024,md210211,NA,NA,NA,-Split-,NA,5474.66,228983
,,,2/11/2021,Journal Entry,10796,SCH210211,NA,NA,NA,-Split-,NA,-12045,216938
,,,2/11/2021,Journal Entry,10796,SCH210211,NA,NA,NA,-Split-,NA,12045,228983
,,,2/11/2021,Journal Entry,11024,md210211,NA,NA,NA,-Split-,NA,-5474.66,223508.34
,,,2/12/2021,Deposit,4467,NA,NA,NA,Smart 210212 SFXS,-Split-,NA,5880.13,229388.47
,,,2/12/2021,Deposit,4464,NA,NA,NA,Smart 210212 SJS,-Split-,NA,2925,232313.47
,,,2/14/2021,Journal Entry,10799,SUN210214,NA,NA,NA,-Split-,NA,-7488,224825.47
,,,2/14/2021,Journal Entry,10799,SUN210214,NA,NA,NA,-Split-,NA,7488,232313.47
,,,2/14/2021,Journal Entry,10799,SUN210214,NA,NA,NA,-Split-,NA,6103,238416.47
,,,2/16/2021,Deposit,4468,NA,NA,NA,UW Metro,3706 Miscellaneous Income:Donations,159,159.95,238576.42
,,,2/19/2021,Deposit,4457,NA,NA,NA,Smart 210219 SFXS,-Split-,NA,13965.41,252541.83
,,,2/19/2021,Journal Entry,10590,PP02192021,NA,NA,94323,-Split-,NA,-60.36,252481.47
,,,2/19/2021,Journal Entry,10590,PP02192021,NA,NA,94324,-Split-,NA,-135.98,252345.49
,,,2/19/2021,Journal Entry,10590,PP02192021,NA,NA,IOI Fee,-Split-,NA,-169.23,252176.26
,,,2/19/2021,Journal Entry,11025,MD210219,NA,NA,NA,-Split-,NA,-27259.31,224916.95
,,,2/19/2021,Journal Entry,11025,MD210219,NA,NA,NA,-Split-,NA,25437,250353.95
,,,2/19/2021,Journal Entry,11025,MD210219,NA,NA,NA,-Split-,NA,27259.31,277613.26
,,,2/19/2021,Check,8982,ACH,Analysis activity,824,NA,4158 Administrative Expenses:Bank Fees,386,-158.88,277454.38
,,,2/19/2021,Journal Entry,10588,PP02192021,NA,NA,Direct Deposits,-Split-,NA,-19994.01,257460.37
,,,2/19/2021,Journal Entry,10588,PP02192021,NA,NA,Taxes,-Split-,NA,-7060.92,250399.45
,,,2/19/2021,Journal Entry,10588,PP02192021,NA,NA,403B,-Split-,NA,-3047.22,247352.23
,,,2/19/2021,Journal Entry,10588,PP02192021,NA,NA,Medical/Dental Sweep,-Split-,NA,-5013,242339.23
,,,2/19/2021,Journal Entry,10588,PP02192021,NA,NA,Life Ins,-Split-,NA,-159.14,242180.09
,,,2/19/2021,Journal Entry,10588,PP02192021,NA,NA,STD,-Split-,NA,-6.5,242173.59
,,,2/19/2021,Journal Entry,10588,PP02192021,NA,NA,Flex,-Split-,NA,-330,241843.59
,,,2/19/2021,Journal Entry,10588,PP02192021,NA,NA,PRMAA,-Split-,NA,-50,241793.59
,,,2/19/2021,Journal Entry,10588,PP02192021,NA,NA,11979,-Split-,NA,-678.84,241114.75
,,,2/19/2021,Journal Entry,10588,PP02192021,NA,NA,IOI Fee,-Split-,NA,-48.68,241066.07
,,,2/19/2021,Journal Entry,10590,PP02192021,NA,NA,Direct Deposits,-Split-,NA,-99152.46,141913.61
,,,2/19/2021,Journal Entry,10590,PP02192021,NA,NA,Taxes,-Split-,NA,-35646.32,106267.29
,,,2/19/2021,Journal Entry,10590,PP02192021,NA,NA,403B,-Split-,NA,-6603.5,99663.79
,,,2/19/2021,Journal Entry,10590,PP02192021,NA,NA,Medical/Dental Sweep,-Split-,NA,-14367.5,85296.29
,,,2/19/2021,Journal Entry,10590,PP02192021,NA,NA,Life Ins,-Split-,NA,-321.73,84974.56
,,,2/19/2021,Journal Entry,10590,PP02192021,NA,NA,STD,-Split-,NA,-61.2,84913.36
,,,2/19/2021,Journal Entry,10590,PP02192021,NA,NA,Flex,-Split-,NA,-365,84548.36
,,,2/19/2021,Journal Entry,10590,PP02192021,NA,NA,94318,-Split-,NA,-1894.83,82653.53
,,,2/19/2021,Journal Entry,10590,PP02192021,NA,NA,94319,-Split-,NA,-1317.96,81335.57
,,,2/19/2021,Journal Entry,10590,PP02192021,NA,NA,94320,-Split-,NA,-138.5,81197.07
,,,2/19/2021,Journal Entry,10590,PP02192021,NA,NA,94321,-Split-,NA,-454.62,80742.45
,,,2/19/2021,Journal Entry,10590,PP02192021,NA,NA,94322,-Split-,NA,-1000.57,79741.88
,,,2/19/2021,Deposit,4458,NA,NA,NA,Smart 210219 SJS,-Split-,NA,3465.44,83207.32
,,,2/21/2021,Journal Entry,10800,SUN210221,NA,NA,NA,-Split-,NA,-6181,77026.32
,,,2/21/2021,Journal Entry,10800,SUN210221,NA,NA,NA,-Split-,NA,6181,83207.32
,,,2/21/2021,Journal Entry,10800,SUN210221,NA,NA,NA,-Split-,NA,5936,89143.32
,,,2/23/2021,Bill Payment (Check),2937,4099,"Robert Portle, M.M.",718,NA,2000 Accounts Payable,217,-88,89055.32
,,,2/23/2021,Bill Payment (Check),2912,4073,Caroline Head,706,NA,2000 Accounts Payable,217,-99,88956.32
,,,2/23/2021,Bill Payment (Check),2939,4101,Sarah Doran,700,NA,2000 Accounts Payable,217,-300,88656.32
,,,2/23/2021,Bill Payment (Check),2940,4102,"Savvas Learning Company, LLC",832,NA,2000 Accounts Payable,217,-49.88,88606.44
,,,2/23/2021,Bill Payment (Check),2941,4103,Shephard Plumbing,154,NA,2000 Accounts Payable,217,-366,88240.44
,,,2/23/2021,Bill Payment (Check),2942,4104,Soul Play,370,NA,2000 Accounts Payable,217,-350,87890.44
,,,2/23/2021,Bill Payment (Check),2943,4105,TelAssist,137,NA,2000 Accounts Payable,217,-100.32,87790.12
,,,2/23/2021,Bill Payment (Check),2944,4106,Terminix SJC,179,NA,2000 Accounts Payable,217,-94,87696.12
,,,2/23/2021,Bill Payment (Check),2945,4107,Terminix SJS,23,NA,2000 Accounts Payable,217,-73,87623.12
,,,2/23/2021,Bill Payment (Check),2946,4108,Village of Wilmette SFX SCH 201120,476,NA,2000 Accounts Payable,217,-478.98,87144.14
,,,2/23/2021,Bill Payment (Check),2947,4109,Village of Wilmette SFX SCH 992090,228,NA,2000 Accounts Payable,217,-175.61,86968.53
,,,2/23/2021,Bill Payment (Check),2948,4110,Worthington Direct,382,NA,2000 Accounts Payable,217,-1264.58,85703.95
,,,2/23/2021,Bill Payment (Check),2901,4062,1XL Learning,582,NA,2000 Accounts Payable,217,-6317,79386.95
,,,2/23/2021,Bill Payment (Check),2902,4063,Accurate Biometrics,24,NA,2000 Accounts Payable,217,-279,79107.95
,,,2/23/2021,Bill Payment (Check),2903,4064,"Active Electrical Supply Co., Inc",107,NA,2000 Accounts Payable,217,-24.27,79083.68
,,,2/23/2021,Bill Payment (Check),2904,4065,Albertsons/Safeway,156,NA,2000 Accounts Payable,217,-556.05,78527.63
,,,2/23/2021,Bill Payment (Check),2905,4066,Anderson Pest Solutions SFX,66,NA,2000 Accounts Payable,217,-79.83,78447.8
,,,2/23/2021,Bill Payment (Check),2906,4067,AT&T SFX ALL 5570 631,169,NA,2000 Accounts Payable,217,-825.06,77622.74
,,,2/23/2021,Bill Payment (Check),2907,4068,AT&T SJC 395,25,NA,2000 Accounts Payable,217,-5.42,77617.32
,,,2/23/2021,Bill Payment (Check),2908,4069,AT&T SJS,235,NA,2000 Accounts Payable,217,-9.97,77607.35
,,,2/23/2021,Bill Payment (Check),2909,4070,Benedictine Sisters Altar Bread,61,NA,2000 Accounts Payable,217,-292.08,77315.27
,,,2/23/2021,Bill Payment (Check),2910,4071,Bridget Clancy,369,"Gross$440,Fed$4.40,SS$27.28,Med$6.38",2000 Accounts Payable,217,-401.94,76913.33
,,,2/23/2021,Bill Payment (Check),2913,4074,Collin McShane,568,NA,2000 Accounts Payable,217,-249.99,76663.34
,,,2/23/2021,Bill Payment (Check),2914,4075,Comcast Business (Internet) SFXS 5692,850,NA,2000 Accounts Payable,217,-449.8,76213.54
,,,2/23/2021,Bill Payment (Check),2915,4076,Comcast Business (TV) SFXS 1576,57,NA,2000 Accounts Payable,217,-42.56,76170.98
,,,2/23/2021,Bill Payment (Check),2916,4077,Constellation BG142404,128,NA,2000 Accounts Payable,217,-1284.43,74886.55
,,,2/23/2021,Bill Payment (Check),2917,4078,Constellation BG91704,127,NA,2000 Accounts Payable,217,-2896.78,71989.77
,,,2/23/2021,Bill Payment (Check),2918,4079,Constellation BG91705,129,NA,2000 Accounts Payable,217,-850.11,71139.66
,,,2/23/2021,Bill Payment (Check),2919,4080,Constellation BG91706,130,NA,2000 Accounts Payable,217,-1238.86,69900.8
,,,2/23/2021,Bill Payment (Check),2920,4081,Crescent Cleaning Company,820,NA,2000 Accounts Payable,217,-439.96,69460.84
,,,2/23/2021,Bill Payment (Check),2921,4082,"Fun Fluency, Inc",509,NA,2000 Accounts Payable,217,-6515,62945.84
,,,2/23/2021,Bill Payment (Check),2922,4083,Garvey's Office Products,134,NA,2000 Accounts Payable,217,-927.53,62018.31
,,,2/23/2021,Bill Payment (Check),2923,4084,"Grage Management, LLC",487,NA,2000 Accounts Payable,217,-412.5,61605.81
,,,2/23/2021,Bill Payment (Check),2924,4085,Hillary Richards,741,NA,2000 Accounts Payable,217,-274,61331.81
,,,2/23/2021,Bill Payment (Check),2925,4086,John Hopkins,101,NA,2000 Accounts Payable,217,-68.83,61262.98
,,,2/23/2021,Bill Payment (Check),2926,4087,Joseph D'Arco,45,NA,2000 Accounts Payable,217,-246,61016.98
,,,2/23/2021,Bill Payment (Check),2927,4089,Junior Library Guild,245,NA,2000 Accounts Payable,217,-408.6,60608.38
,,,2/23/2021,Bill Payment (Check),2928,4090,Leo Agustina,373,NA,2000 Accounts Payable,217,-100,60508.38
,,,2/23/2021,Bill Payment (Check),2929,4091,Linda Sawyer,243,NA,2000 Accounts Payable,217,-16.48,60491.9
,,,2/23/2021,Bill Payment (Check),2930,4092,Mary Kate Georgalas,47,NA,2000 Accounts Payable,217,-10,60481.9
,,,2/23/2021,Bill Payment (Check),2931,4093,Meco Electric Company Inc.,147,NA,2000 Accounts Payable,217,-12814.5,47667.4
,,,2/23/2021,Bill Payment (Check),2932,4094,New Trier Multi-Faith Alliance,368,NA,2000 Accounts Payable,217,-200,47467.4
,,,2/23/2021,Bill Payment (Check),2933,4095,Nicole Collins,272,NA,2000 Accounts Payable,217,-97.98,47369.42
,,,2/23/2021,Bill Payment (Check),2934,4096,Nicor SFX Sch,168,NA,2000 Accounts Payable,217,-220.67,47148.75
,,,2/23/2021,Bill Payment (Check),2935,4097,Office Depot Business Credit,139,NA,2000 Accounts Payable,217,-99.9,47048.85
,,,2/23/2021,Bill Payment (Check),2936,4098,Rich Jakubik,374,NA,2000 Accounts Payable,217,-75,46973.85
,,,2/23/2021,Journal Entry,11026,MD210223,NA,NA,NA,-Split-,NA,-7818.13,39155.72
,,,2/23/2021,Journal Entry,11026,MD210223,NA,NA,NA,-Split-,NA,6818.13,45973.85
,,,2/23/2021,Journal Entry,11026,MD210223,NA,NA,NA,-Split-,NA,7818.13,53791.98
,,,2/23/2021,Bill Payment (Check),2911,4072,Bye-Mor Inc.,284,NA,2000 Accounts Payable,217,-132,53659.98
,,,2/23/2021,Bill Payment (Check),2938,4100,"S2Verify, LLC",94,NA,2000 Accounts Payable,217,-103.36,53556.62
,,,2/24/2021,Journal Entry,11027,MD210224,NA,NA,NA,-Split-,NA,-3825,49731.62
,,,2/24/2021,Journal Entry,11027,MD210224,NA,NA,NA,-Split-,NA,3825,53556.62
,,,2/24/2021,Journal Entry,11027,MD210224,NA,NA,NA,-Split-,NA,3585,57141.62
,,,2/25/2021,Bill Payment (Check),2954,4088,Cecil Painting,164,NA,2000 Accounts Payable,217,-3600,53541.62
,,,2/25/2021,Deposit,4460,NA,NA,NA,Smart 210225,-Split-,NA,14711.4,68253.02
,,,2/25/2021,Deposit,4459,NA,NA,NA,Smart 210225 SFXS,-Split-,NA,168111.88,236364.9
,,,2/26/2021,Deposit,4462,NA,NA,NA,Smart 210226 SFXS,-Split-,NA,1535.86,237900.76
,,,2/26/2021,Deposit,4461,NA,NA,NA,Smart 210226 SJS,-Split-,NA,1194.06,239094.82
,,,2/28/2021,Journal Entry,10802,SUN210228,NA,NA,NA,-Split-,NA,-28756,210338.82
,,,2/28/2021,Journal Entry,10802,SUN210228,NA,NA,NA,-Split-,NA,25521,235859.82
,,,2/28/2021,Journal Entry,10802,SUN210228,NA,NA,NA,-Split-,NA,28756,264615.82
,,,3/2/2021,Bill Payment (Check),2955,4116,Cecil Painting,164,NA,2000 Accounts Payable,217,-600,264015.82
,,,3/5/2021,Journal Entry,11029,PP20210305,NA,NA,403B,-Split-,NA,-6577.12,257438.7
,,,3/5/2021,Journal Entry,11029,PP20210305,NA,NA,Life Ins,-Split-,NA,-321.73,257116.97
,,,3/5/2021,Journal Entry,11029,PP20210305,NA,NA,STD,-Split-,NA,-57.57,257059.4
,,,3/5/2021,Journal Entry,11029,PP20210305,NA,NA,Flex,-Split-,NA,-365,256694.4
,,,3/5/2021,Journal Entry,11029,PP20210305,NA,NA,94325,-Split-,NA,-1847.8,254846.6
,,,3/5/2021,Journal Entry,11029,PP20210305,NA,NA,94326,-Split-,NA,-91.95,254754.65
,,,3/5/2021,Journal Entry,11029,PP20210305,NA,NA,94327,-Split-,NA,-1259.77,253494.88
,,,3/5/2021,Journal Entry,11029,PP20210305,NA,NA,94328,-Split-,NA,-363.5,253131.38
,,,3/5/2021,Journal Entry,11029,PP20210305,NA,NA,94329,-Split-,NA,-449.78,252681.6
,,,3/5/2021,Journal Entry,11029,PP20210305,NA,NA,94330,-Split-,NA,-759.33,251922.27
,,,3/5/2021,Journal Entry,11029,PP20210305,NA,NA,94331,-Split-,NA,-185.72,251736.55
,,,3/5/2021,Journal Entry,11029,PP20210305,NA,NA,94332,-Split-,NA,-392.47,251344.08
,,,3/5/2021,Journal Entry,11029,PP20210305,NA,NA,IOI Fee,-Split-,NA,-169.62,251174.46
,,,3/5/2021,Journal Entry,11030,PP20210305,NA,NA,Direct Deposits,-Split-,NA,-20638.89,230535.57
,,,3/5/2021,Journal Entry,11030,PP20210305,NA,NA,Taxes,-Split-,NA,-7123.74,223411.83
,,,3/5/2021,Journal Entry,11030,PP20210305,NA,NA,403B,-Split-,NA,-3046.36,220365.47
,,,3/5/2021,Journal Entry,11030,PP20210305,NA,NA,Life Ins,-Split-,NA,-159.14,220206.33
,,,3/5/2021,Journal Entry,11030,PP20210305,NA,NA,STD,-Split-,NA,-6.5,220199.83
,,,3/5/2021,Journal Entry,11030,PP20210305,NA,NA,Flex,-Split-,NA,-330,219869.83
,,,3/5/2021,Journal Entry,11030,PP20210305,NA,NA,PRMAA,-Split-,NA,-50,219819.83
,,,3/5/2021,Journal Entry,11030,PP20210305,NA,NA,11980,-Split-,NA,-140.41,219679.42
,,,3/5/2021,Journal Entry,11030,PP20210305,NA,NA,IOI Fee,-Split-,NA,-50.25,219629.17
,,,3/5/2021,Journal Entry,11029,PP20210305,NA,NA,Direct Deposits,-Split-,NA,-96045.57,123583.6
,,,3/5/2021,Journal Entry,11029,PP20210305,NA,NA,Taxes,-Split-,NA,-34553.67,89029.93
,,,3/10/2021,Bill Payment (Check),3001,4162,Jesuit Community of Loyola University,360,NA,2000 Accounts Payable,217,-200,88829.93
,,,3/10/2021,Bill Payment (Check),2961,4122,Annie Buxton,623,NA,2000 Accounts Payable,217,-225,88604.93
,,,3/10/2021,Bill Payment (Check),2962,4123,Archdiocese of Chicago,96,NA,2000 Accounts Payable,217,-23.28,88581.65
,,,3/10/2021,Bill Payment (Check),2963,4124,AT&T SJC YFF 2253,448,NA,2000 Accounts Payable,217,-82.65,88499
,,,3/10/2021,Bill Payment (Check),2964,4125,Barton Cotton,895,NA,2000 Accounts Payable,217,-252.51,88246.49
,,,3/10/2021,Bill Payment (Check),2965,4126,Brian Roselle,885,NA,2000 Accounts Payable,217,-900,87346.49
,,,3/10/2021,Bill Payment (Check),2966,4127,Canisius House Jesuit Community,450,NA,2000 Accounts Payable,217,-100,87246.49
,,,3/10/2021,Bill Payment (Check),2967,4128,Canon,258,NA,2000 Accounts Payable,217,-1522,85724.49
,,,3/10/2021,Bill Payment (Check),2968,4129,Canon Maintanence,563,NA,2000 Accounts Payable,217,-647.37,85077.12
,,,3/10/2021,Bill Payment (Check),3019,4180,"Schaefer's Wines, Foods & Spirits",56,NA,2000 Accounts Payable,217,-59.03,85018.09
,,,3/10/2021,Bill Payment (Check),3024,4185,The New York Times,140,NA,2000 Accounts Payable,217,-6,85012.09
,,,3/10/2021,Bill Payment (Check),3025,4186,Verizon Wireless,118,NA,2000 Accounts Payable,217,-88.25,84923.84
,,,3/10/2021,Bill Payment (Check),3002,4163,Joanne Brinceanu,389,NA,2000 Accounts Payable,217,-275,84648.84
,,,3/10/2021,Bill Payment (Check),3003,4164,Johnson Controls SFX CH 7578,474,NA,2000 Accounts Payable,217,-249.35,84399.49
,,,3/10/2021,Bill Payment (Check),3004,4165,Johnson Controls SFX SCH 7898,473,NA,2000 Accounts Payable,217,-215.91,84183.58
,,,3/10/2021,Bill Payment (Check),3005,4166,Junior Library Guild,245,NA,2000 Accounts Payable,217,-195,83988.58
,,,3/10/2021,Bill Payment (Check),3006,4167,Kieran Stack,380,NA,2000 Accounts Payable,217,-300,83688.58
,,,3/10/2021,Bill Payment (Check),3007,4168,Loyola Press SFX SCH,400,NA,2000 Accounts Payable,217,-937.44,82751.14
,,,3/10/2021,Bill Payment (Check),3008,4169,Loyola Press YFF,833,NA,2000 Accounts Payable,217,-781.2,81969.94
,,,3/10/2021,Bill Payment (Check),3009,4170,Matt Hayes,379,NA,2000 Accounts Payable,217,-600,81369.94
,,,3/10/2021,Bill Payment (Check),3010,4171,Matt Lafontaine,378,NA,2000 Accounts Payable,217,-300,81069.94
,,,3/10/2021,Bill Payment (Check),3011,4172,Max Gunnill,377,NA,2000 Accounts Payable,217,-800,80269.94
,,,3/10/2021,Bill Payment (Check),3012,4173,Millen Hardware,155,NA,2000 Accounts Payable,217,-248.54,80021.4
,,,3/10/2021,Bill Payment (Check),3013,4174,Nicor SFX Sch,168,NA,2000 Accounts Payable,217,-45.02,79976.38
,,,3/10/2021,Bill Payment (Check),3014,4175,Nicor SJ Convent,12,NA,2000 Accounts Payable,217,-1040.9,78935.48
,,,3/10/2021,Bill Payment (Check),3015,4176,Patti Tsuru,886,NA,2000 Accounts Payable,217,-89,78846.48
,,,3/10/2021,Bill Payment (Check),3016,4177,Pitney Bowes SFXS 0015503825,488,NA,2000 Accounts Payable,217,-293.45,78553.03
,,,3/10/2021,Bill Payment (Check),3017,4178,Printwell,418,NA,2000 Accounts Payable,217,-500,78053.03
,,,3/10/2021,Bill Payment (Check),3018,4179,"Savvas Learning Company, LLC",832,NA,2000 Accounts Payable,217,-268.92,77784.11
,,,3/10/2021,Bill Payment (Check),3020,4181,Scott Dolan,376,NA,2000 Accounts Payable,217,-200,77584.11
,,,3/10/2021,Bill Payment (Check),3021,4182,Scott Girard,375,NA,2000 Accounts Payable,217,-800,76784.11
,,,3/10/2021,Bill Payment (Check),3022,4183,Shephard Plumbing,154,NA,2000 Accounts Payable,217,-475,76309.11
,,,3/10/2021,Bill Payment (Check),3023,4184,Staples SJ,92,NA,2000 Accounts Payable,217,-440.19,75868.92
,,,3/10/2021,Bill Payment (Check),3026,4195,Wayne Watts,241,NA,2000 Accounts Payable,217,-250.76,75618.16
,,,3/10/2021,Bill Payment (Check),3030,NA,Catholic Bishop of Chicago (BillingSFXS),548,QuickBooks generated zero amount transaction for bill payment stub,2000 Accounts Payable,217,0,75618.16
,,,3/10/2021,Bill Payment (Check),3031,4196,Catholic Bishop of Chicago (BillingSFXS),548,NA,2000 Accounts Payable,217,-56539.75,19078.41
,,,3/10/2021,Bill Payment (Check),3032,4197,Catholic Bishop of Chicago (BillingSJS),547,NA,2000 Accounts Payable,217,-20494.93,-1416.52
,,,3/10/2021,Bill Payment (Check),3033,4198,Catholic Bishop of Chicago (BillingSSJFX),359,NA,2000 Accounts Payable,217,-64372.7,-65789.22
,,,3/10/2021,Bill Payment (Check),2956,4117,Advanced Disposal SFX Sch,60,NA,2000 Accounts Payable,217,-457.03,-66246.25
,,,3/10/2021,Bill Payment (Check),2957,4118,Advanced Disposal SJ CH,108,NA,2000 Accounts Payable,217,-429.81,-66676.06
,,,3/10/2021,Bill Payment (Check),2958,4119,Altorfer Industries Inc,867,NA,2000 Accounts Payable,217,-12796,-79472.06
,,,3/10/2021,Bill Payment (Check),2959,4120,Amy Butterworth,119,NA,2000 Accounts Payable,217,-20,-79492.06
,,,3/10/2021,Bill Payment (Check),2960,4121,Anderson Lock,185,NA,2000 Accounts Payable,217,-114,-79606.06
,,,3/10/2021,Bill Payment (Check),2969,4130,Canon SFX,524,NA,2000 Accounts Payable,217,-234,-79840.06
,,,3/10/2021,Bill Payment (Check),2970,4131,Catholic Bishop of Chicago,4,NA,2000 Accounts Payable,217,-38.5,-79878.56
,,,3/10/2021,Bill Payment (Check),2971,4132,Chicago Tribune,222,NA,2000 Accounts Payable,217,-136,-80014.56
,,,3/10/2021,Bill Payment (Check),2972,4133,Chris Farr,884,NA,2000 Accounts Payable,217,-1100,-81114.56
,,,3/10/2021,Bill Payment (Check),2973,4134,Comcast Business (TV) SFXS 1576,57,NA,2000 Accounts Payable,217,-85.12,-81199.68
,,,3/10/2021,Bill Payment (Check),2974,4135,Comcast SFX Office 2331,142,NA,2000 Accounts Payable,217,-130.61,-81330.29
,,,3/10/2021,Bill Payment (Check),2975,4136,Comcast SFX Rectory 2307,170,NA,2000 Accounts Payable,217,-238.01,-81568.3
,,,3/10/2021,Bill Payment (Check),2976,4137,Constellation BG142404,128,NA,2000 Accounts Payable,217,-679.64,-82247.94
,,,3/10/2021,Bill Payment (Check),2977,4138,Constellation BG91704,127,NA,2000 Accounts Payable,217,-2362.92,-84610.86
,,,3/10/2021,Bill Payment (Check),2978,4139,Constellation BG91705,129,NA,2000 Accounts Payable,217,-666.99,-85277.85
,,,3/10/2021,Bill Payment (Check),2979,4140,Constellation BG91706,130,NA,2000 Accounts Payable,217,-777.46,-86055.31
,,,3/10/2021,Bill Payment (Check),2980,4141,Constellation BG92628,90,NA,2000 Accounts Payable,217,-3572.47,-89627.78
,,,3/10/2021,Bill Payment (Check),2981,4142,Constellation BG92634,91,NA,2000 Accounts Payable,217,-2391.37,-92019.15
,,,3/10/2021,Bill Payment (Check),2982,4143,Crescent Cleaning Company,820,NA,2000 Accounts Payable,217,-17849.17,-109868.32
,,,3/10/2021,Bill Payment (Check),2983,4144,Daniel Mayall,85,NA,2000 Accounts Payable,217,-63,-109931.32
,,,3/10/2021,Bill Payment (Check),2984,4145,Edward Harnett,121,NA,2000 Accounts Payable,217,-672,-110603.32
,,,3/10/2021,Bill Payment (Check),2985,4146,Engie Resources Convent SJ,112,NA,2000 Accounts Payable,217,-250.52,-110853.84
,,,3/10/2021,Bill Payment (Check),2986,4147,Engie Resources SJ Campus,111,NA,2000 Accounts Payable,217,-1598.82,-112452.66
,,,3/10/2021,Bill Payment (Check),2987,4148,Engie SFX,253,NA,2000 Accounts Payable,217,-3869.28,-116321.94
,,,3/10/2021,Bill Payment (Check),2988,4149,F.J. Kerrigan Plumbing Co. Inc,87,NA,2000 Accounts Payable,217,-1008.1,-117330.04
,,,3/10/2021,Bill Payment (Check),2989,4150,FP Mailing Solutions,114,NA,2000 Accounts Payable,217,-86.85,-117416.89
,,,3/10/2021,Bill Payment (Check),2990,4151,FP Mailing Solutions SJS,381,NA,2000 Accounts Payable,217,-133.06,-117549.95
,,,3/10/2021,Bill Payment (Check),2991,4152,Garvey's Office Products,134,NA,2000 Accounts Payable,217,-1253.46,-118803.41
,,,3/10/2021,Bill Payment (Check),2992,4153,George Weschler,291,NA,2000 Accounts Payable,217,-7,-118810.41
,,,3/10/2021,Bill Payment (Check),2993,4154,Gil Calderon,883,NA,2000 Accounts Payable,217,-100,-118910.41
,,,3/10/2021,Bill Payment (Check),2994,4155,GO Technology Group Inc.,64,NA,2000 Accounts Payable,217,-1800,-120710.41
,,,3/10/2021,Bill Payment (Check),2995,4156,"Grage Management, LLC",487,NA,2000 Accounts Payable,217,-700,-121410.41
,,,3/10/2021,Bill Payment (Check),2996,4157,Illinois Office of the State Fire Marshal,508,NA,2000 Accounts Payable,217,-95,-121505.41
,,,3/10/2021,Bill Payment (Check),2997,4158,Jaime Vehovsky,48,NA,2000 Accounts Payable,217,-127,-121632.41
,,,3/10/2021,Bill Payment (Check),2998,4159,James Slater,882,NA,2000 Accounts Payable,217,-2400,-124032.41
,,,3/10/2021,Bill Payment (Check),2999,4160,Janina Jakucewicz,138,NA,2000 Accounts Payable,217,-186.42,-124218.83
,,,3/10/2021,Bill Payment (Check),3000,4161,Jennifer Miller,262,NA,2000 Accounts Payable,217,-2253,-126471.83
1101.20 Checking Restricted,587,,,,,,,,,,,,
1101.22 Building Restricted,NA,,,,,,,,,,,,
,,59595,,,,,,,,,,,
,,,1/1/2021,Journal Entry,10581,GC 210101,NA,NA,capital projects,-Split-,NA,850,60445
,,,1/3/2021,Journal Entry,10570,SUN 210103,NA,NA,NA,-Split-,NA,7,60452
,,,1/7/2021,Journal Entry,10586,210107 MD,NA,NA,NA,-Split-,NA,20,60472
,,,1/7/2021,Journal Entry,10586,210107 MD,NA,NA,NA,-Split-,NA,10000,70472
,,,1/10/2021,Journal Entry,10573,SUN 200110,NA,NA,NA,-Split-,NA,1390,71862
,,,1/12/2021,Journal Entry,10574,MD 210112,NA,NA,NA,-Split-,NA,5500,77362
,,,1/17/2021,Journal Entry,10575,SUN 210117,NA,NA,NA,-Split-,NA,25,77387
,,,1/18/2021,Journal Entry,10576,MD 210118,NA,NA,NA,-Split-,NA,1000,78387
,,,1/27/2021,Bill Payment (Check),2835,3996,"Virgil James, Inc",320,NA,2000 Accounts Payable,217,-36112.16,42274.84
,,,2/1/2021,Journal Entry,11028,GC FEB 2021,NA,NA,capital projects,-Split-,NA,15,42289.84
,,,2/19/2021,Journal Entry,11025,MD210219,NA,NA,HEARING LOOP,-Split-,NA,1487.31,43777.15
,,,2/23/2021,Bill Payment (Check),2951,4113,"Tile Decor, Inc",371,Voided - VOID:,2000 Accounts Payable,217,0,43777.15
,,,2/23/2021,Bill Payment (Check),2950,4112,"Holton Brothers, Inc",643,NA,2000 Accounts Payable,217,-15860,27917.15
,,,2/23/2021,Bill Payment (Check),2949,4111,"Bruno Construction Masonry, Inc",372,Voided - VOID:,2000 Accounts Payable,217,0,27917.15
,,,2/24/2021,Bill Payment (Check),2952,4114,"Bruno Construction Masonry, Inc",372,NA,2000 Accounts Payable,217,-2600,25317.15
,,,2/24/2021,Bill Payment (Check),2953,4115,"Tile Decor, Inc",371,NA,2000 Accounts Payable,217,-1070,24247.15
,,,3/10/2021,Bill Payment (Check),3029,4191,"Virgil James, Inc",320,NA,2000 Accounts Payable,217,-20676.82,3570.33
1101.23 School Support Restricted,675,,,,,,,,,,,,
,,4591,,,,,,,,,,,
1101.24 AOC A/P Restricted,588,,,,,,,,,,,,
,,63,,,,,,,,,,,
101.24A Latin America,621,,,,,,,,,,,,
,,25,,,,,,,,,,,
,,,1/1/2021,Journal Entry,10581,GC 210101,NA,NA,NA,-Split-,NA,360,385
,,,1/10/2021,Journal Entry,10572,SPEC 210110,NA,NA,NA,-Split-,NA,75,460
,,,1/17/2021,Journal Entry,10575,SUN 210117,NA,NA,NA,-Split-,NA,20,480
,,,1/24/2021,Journal Entry,10578,SUN 210124,NA,NA,NA,-Split-,NA,590,1070
,,,1/31/2021,Journal Entry,10582,SUNC 210131,NA,NA,NA,-Split-,NA,100,1170
,,,2/1/2021,Journal Entry,11028,GC FEB 2021,NA,NA,NA,-Split-,NA,15,1185
,,,2/3/2021,Journal Entry,10583,MD 210203,NA,NA,NA,-Split-,NA,50,1235
,,,2/7/2021,Journal Entry,10783,SUN 210207,NA,NA,NA,-Split-,NA,26,1261
,,,2/11/2021,Journal Entry,11024,md210211,NA,NA,NA,-Split-,NA,30,1291
,,,2/14/2021,Journal Entry,10799,SUN210214,NA,NA,NA,-Split-,NA,35,1326
,,,2/28/2021,Journal Entry,10802,SUN210228,NA,NA,NA,-Split-,NA,100,1426
101.24C Aid Cent. and East. Europe,679,,,,,,,,,,,,
,,1050,,,,,,,,,,,
,,,2/3/2021,Journal Entry,10583,MD 210203,NA,NA,NA,-Split-,NA,25,1075
,,,2/10/2021,Bill Payment (Check),2881,4041,Department of Stewardship and Development,323,NA,2000 Accounts Payable,217,-1050,25
101.24D Holy Land,602,,,,,,,,,,,,
,,176,,,,,,,,,,,
,,,2/28/2021,Journal Entry,10802,SUN210228,NA,NA,good fri,-Split-,NA,65,241
101.24E Catholic Charities,652,,,,,,,,,,,,
,,1216,,,,,,,,,,,
,,,1/1/2021,Journal Entry,10581,GC 210101,NA,NA,NA,-Split-,NA,100,1316
,,,1/31/2021,Journal Entry,10582,SUNC 210131,NA,NA,NA,-Split-,NA,20,1336
,,,2/1/2021,Journal Entry,11028,GC FEB 2021,NA,NA,NA,-Split-,NA,800,2136
,,,2/10/2021,Bill Payment (Check),2880,4042,Catholic Charities,35,NA,2000 Accounts Payable,217,-1216,920
,,,2/28/2021,Journal Entry,10802,SUN210228,NA,NA,NA,-Split-,NA,150,1070
101.24F Retired Priests,603,,,,,,,,,,,,
,,2650,,,,,,,,,,,
,,,2/10/2021,Bill Payment (Check),2882,4043,Priests' Health and Retirement,324,NA,2000 Accounts Payable,217,-2650,0
,,,2/28/2021,Journal Entry,10802,SUN210228,NA,NA,NA,-Split-,NA,50,50
101.24G Peter's Pence,705,,,,,,,,,,,,
,,1210,,,,,,,,,,,
,,,2/28/2021,Journal Entry,10802,SUN210228,NA,NA,NA,-Split-,NA,25,1235
101.24H Seminarian Edu.,604,,,,,,,,,,,,
,,2930,,,,,,,,,,,
,,,1/3/2021,Journal Entry,10570,SUN 210103,NA,NA,NA,-Split-,NA,5,2935
,,,2/10/2021,Bill Payment (Check),2884,4044,Seminarian Collection,592,NA,2000 Accounts Payable,217,-2935,0
,,,2/28/2021,Journal Entry,10802,SUN210228,NA,NA,NA,-Split-,NA,100,100
101.24I World MIssion Sunday,653,,,,,,,,,,,,
,,1983,,,,,,,,,,,
,,,1/3/2021,Journal Entry,10570,SUN 210103,NA,NA,NA,-Split-,NA,5,1988
,,,2/10/2021,Bill Payment (Check),2885,4045,Society of Propagation of Faith,593,NA,2000 Accounts Payable,217,-1988,0
,,,2/28/2021,Journal Entry,10802,SUN210228,NA,NA,NA,-Split-,NA,75,75
101.24J CCHD,605,,,,,,,,,,,,
,,4665,,,,,,,,,,,
,,,2/1/2021,Journal Entry,11028,GC FEB 2021,NA,NA,NA,-Split-,NA,100,4765
,,,2/10/2021,Bill Payment (Check),2879,4046,Catholic Campaign for Human Development,365,NA,2000 Accounts Payable,217,-4665,100
,,,2/11/2021,Journal Entry,11024,md210211,NA,NA,NA,-Split-,NA,80,180
,,,2/14/2021,Journal Entry,10799,SUN210214,NA,NA,NA,-Split-,NA,75,255
,,,2/19/2021,Journal Entry,11025,MD210219,NA,NA,NA,-Split-,NA,20,275
,,,2/24/2021,Journal Entry,11027,MD210224,NA,NA,NA,-Split-,NA,10,285
,,,2/28/2021,Journal Entry,10802,SUN210228,NA,NA,NA,-Split-,NA,50,335
,,,2/28/2021,Journal Entry,10802,SUN210228,NA,NA,NA,-Split-,NA,530,865
101.24K Retirement Fund for Religious,680,,,,,,,,,,,,
,,1713.42,,,,,,,,,,,
,,,1/1/2021,Journal Entry,10581,GC 210101,NA,NA,NA,-Split-,NA,100,1813.42
,,,1/3/2021,Journal Entry,10570,SUN 210103,NA,NA,NA,-Split-,NA,150,1963.42
,,,2/1/2021,Journal Entry,11028,GC FEB 2021,NA,NA,NA,-Split-,NA,275,2238.42
,,,2/10/2021,Bill Payment (Check),2883,4047,Retirement Fund for Religious,364,NA,2000 Accounts Payable,217,-1863.42,375
,,,2/28/2021,Journal Entry,10802,SUN210228,NA,NA,NA,-Split-,NA,100,475
101.24L Missionary Co-Op,606,,,,,,,,,,,,
,,460,,,,,,,,,,,
,,,2/1/2021,Journal Entry,11028,GC FEB 2021,NA,NA,NA,-Split-,NA,500,960
,,,2/28/2021,Journal Entry,10802,SUN210228,NA,NA,NA,-Split-,NA,25,985
1101.25 Church Restricted,701,,,,,,,,,,,,
101.25A Sharing - St. Ignatius,NA,,,,,,,,,,,,
,,14271,,,,,,,,,,,
,,,1/1/2021,Journal Entry,10581,GC 210101,NA,NA,NA,-Split-,NA,280,14551
,,,1/3/2021,Journal Entry,10570,SUN 210103,NA,NA,NA,-Split-,NA,8,14559
,,,1/7/2021,Journal Entry,10586,210107 MD,NA,NA,NA,-Split-,NA,30,14589
,,,1/10/2021,Journal Entry,10572,SPEC 210110,NA,NA,NA,-Split-,NA,705,15294
,,,1/17/2021,Journal Entry,10575,SUN 210117,NA,NA,NA,-Split-,NA,265,15559
,,,1/24/2021,Journal Entry,10578,SUN 210124,NA,NA,NA,-Split-,NA,70,15629
,,,1/31/2021,Journal Entry,10582,SUNC 210131,NA,NA,NA,-Split-,NA,345,15974
,,,2/1/2021,Journal Entry,11028,GC FEB 2021,NA,NA,NA,-Split-,NA,165,16139
,,,2/3/2021,Journal Entry,10583,MD 210203,NA,NA,NA,-Split-,NA,25,16164
,,,2/7/2021,Journal Entry,10783,SUN 210207,NA,NA,NA,-Split-,NA,497,16661
,,,2/11/2021,Journal Entry,11024,md210211,NA,NA,NA,-Split-,NA,100,16761
,,,2/14/2021,Journal Entry,10799,SUN210214,NA,NA,NA,-Split-,NA,405,17166
,,,2/19/2021,Journal Entry,11025,MD210219,NA,NA,NA,-Split-,NA,135,17301
,,,2/21/2021,Journal Entry,10800,SUN210221,NA,NA,NA,-Split-,NA,210,17511
,,,2/24/2021,Journal Entry,11027,MD210224,NA,NA,NA,-Split-,NA,10,17521
,,,2/28/2021,Journal Entry,10802,SUN210228,NA,NA,NA,-Split-,NA,610,18131
101.25B Sharing - St. Thomas School,657,,,,,,,,,,,,
,,24926,,,,,,,,,,,
,,,1/1/2021,Journal Entry,10581,GC 210101,NA,NA,NA,-Split-,NA,1362,26288
,,,1/3/2021,Journal Entry,10570,SUN 210103,NA,NA,NA,-Split-,NA,317,26605
,,,1/10/2021,Journal Entry,10572,SPEC 210110,NA,NA,NA,-Split-,NA,195,26800
,,,1/12/2021,Journal Entry,10574,MD 210112,NA,NA,NA,-Split-,NA,100,26900
,,,1/17/2021,Journal Entry,10575,SUN 210117,NA,NA,NA,-Split-,NA,926,27826
,,,1/24/2021,Journal Entry,10578,SUN 210124,NA,NA,NA,-Split-,NA,20,27846
,,,1/31/2021,Journal Entry,10582,SUNC 210131,NA,NA,NA,-Split-,NA,220,28066
,,,2/1/2021,Journal Entry,11028,GC FEB 2021,NA,NA,NA,-Split-,NA,1277,29343
,,,2/3/2021,Journal Entry,10583,MD 210203,NA,NA,NA,-Split-,NA,155,29498
,,,2/7/2021,Journal Entry,10783,SUN 210207,NA,NA,NA,-Split-,NA,101,29599
,,,2/11/2021,Journal Entry,11024,md210211,NA,NA,NA,-Split-,NA,90,29689
,,,2/14/2021,Journal Entry,10799,SUN210214,NA,NA,NA,-Split-,NA,330,30019
,,,2/14/2021,Journal Entry,10799,SUN210214,NA,NA,NA,-Split-,NA,-330,29689
,,,2/19/2021,Journal Entry,11025,MD210219,NA,NA,NA,-Split-,NA,20,29709
,,,2/23/2021,Journal Entry,11026,MD210223,NA,NA,NA,-Split-,NA,500,30209
,,,2/24/2021,Journal Entry,11027,MD210224,NA,NA,NA,-Split-,NA,60,30269
,,,2/28/2021,Journal Entry,10802,SUN210228,NA,NA,NA,-Split-,NA,810,31079
,,,3/10/2021,Bill Payment (Check),3027,4192,St. Thomas of Canterbury School,338,NA,2000 Accounts Payable,217,-28221,2858
101.25C Sharing- St. Thomas Food Pantry,695,,,,,,,,,,,,
,,24901,,,,,,,,,,,
,,,1/1/2021,Journal Entry,10581,GC 210101,NA,NA,soup kitchen,-Split-,NA,350,25251
,,,1/31/2021,Journal Entry,10582,SUNC 210131,NA,NA,NA,-Split-,NA,25,25276
,,,2/1/2021,Journal Entry,11028,GC FEB 2021,NA,NA,soup kitchen,-Split-,NA,150,25426
,,,2/3/2021,Journal Entry,10583,MD 210203,NA,NA,NA,-Split-,NA,250,25676
,,,2/19/2021,Journal Entry,11025,MD210219,NA,NA,NA,-Split-,NA,20,25696
,,,2/28/2021,Journal Entry,10802,SUN210228,NA,NA,NA,-Split-,NA,40,25736
101.25E SVDP,659,,,,,,,,,,,,
,,11342,,,,,,,,,,,
,,,1/1/2021,Journal Entry,10581,GC 210101,NA,NA,NA,-Split-,NA,460,11802
,,,1/29/2021,Transfer,4504,NA,NA,NA,transfer of funds to restricted account,1240.02 Oper. Savings at the Arch Bank:Stock Savings Account:SFX Stock/Mut Fund #701430250,651,500,12302
,,,1/31/2021,Journal Entry,10582,SUNC 210131,NA,NA,NA,-Split-,NA,1000,13302
,,,2/1/2021,Journal Entry,11028,GC FEB 2021,NA,NA,NA,-Split-,NA,360,13662
,,,2/28/2021,Journal Entry,10802,SUN210228,NA,NA,holy thurs,-Split-,NA,140,13802
,,,3/10/2021,Bill Payment (Check),3028,4193,St. Vincent De Paul,249,NA,2000 Accounts Payable,217,-13302,500
101.25G TTWCI,665,,,,,,,,,,,,
,,,1/4/2021,Deposit,4441,NA,NA,NA,TTWCI,"5115.02 Fund Collections:""To Teach Who Christ Is"" Campgn:St Francis Xavier TTWCI Campagn",431,50000,50000
,,,1/13/2021,Bill Payment (Check),2820,3950,To Teach Who Christ Is,559,NA,2000 Accounts Payable,217,-50000,0
101.25H Fr. Rodlin,694,,,,,,,,,,,,
,,3707.95,,,,,,,,,,,
101.25I ACTION,667,,,,,,,,,,,,
,,4500,,,,,,,,,,,
,,,1/1/2021,Journal Entry,10581,GC 210101,NA,NA,NA,-Split-,NA,850,5350
,,,1/31/2021,Journal Entry,10582,SUNC 210131,NA,NA,memorial for PJP,-Split-,NA,200,5550
,,,2/1/2021,Journal Entry,11028,GC FEB 2021,NA,NA,NA,-Split-,NA,1000,6550
,,,2/3/2021,Journal Entry,10583,MD 210203,NA,NA,in memory of PJP,-Split-,NA,250,6800
,,,2/3/2021,Journal Entry,10583,MD 210203,NA,NA,$ transfer from old bank account,-Split-,NA,6500,13300
,,,2/7/2021,Journal Entry,10783,SUN 210207,NA,NA,NA,-Split-,NA,100,13400
,,,2/28/2021,Journal Entry,10802,SUN210228,NA,NA,NA,-Split-,NA,100,13500
101.25J Alms Giving,683,,,,,,,,,,,,
,,,2/1/2021,Journal Entry,11028,GC FEB 2021,NA,NA,ASH,-Split-,NA,1400,1400
,,,2/11/2021,Journal Entry,11024,md210211,NA,NA,ASH,-Split-,NA,40,1440
,,,2/14/2021,Journal Entry,10799,SUN210214,NA,NA,NA,-Split-,NA,60,1500
,,,2/17/2021,Deposit,4453,NA,NA,NA,ASH WED,3045 Other Collections:Almsgiving,369,4038,5538
,,,2/19/2021,Journal Entry,11025,MD210219,NA,NA,ASH,-Split-,NA,75,5613
,,,2/24/2021,Journal Entry,11027,MD210224,NA,NA,ASH,-Split-,NA,70,5683
,,,2/28/2021,Journal Entry,10802,SUN210228,NA,NA,ASH,-Split-,NA,145,5828
1101.27 Athletics,623,,,,,,,,,,,,
,,-11379.97,,,,,,,,,,,
1101.29 Haiti,697,,,,,,,,,,,,
101.29A Haiti General Fund,NA,,,,,,,,,,,,
,,43368.85,,,,,,,,,,,
,,,1/3/2021,Journal Entry,10570,SUN 210103,NA,NA,NA,-Split-,NA,547,43915.85
,,,1/7/2021,Journal Entry,10584,wire transf,NA,NA,NA,-Split-,NA,-7559,36356.85
,,,1/7/2021,Journal Entry,10586,210107 MD,NA,NA,NA,-Split-,NA,10,36366.85
,,,1/10/2021,Journal Entry,10572,SPEC 210110,NA,NA,NA,-Split-,NA,550,36916.85
,,,1/12/2021,Journal Entry,10574,MD 210112,NA,NA,NA,-Split-,NA,100,37016.85
,,,1/13/2021,Bill Payment (Check),2819,3951,Mike Henn,79,NA,2000 Accounts Payable,217,-4060,32956.85
,,,1/17/2021,Journal Entry,10575,SUN 210117,NA,NA,NA,-Split-,NA,360,33316.85
,,,1/18/2021,Journal Entry,10576,MD 210118,NA,NA,NA,-Split-,NA,500,33816.85
,,,1/22/2021,Journal Entry,10577,MD 210122,NA,NA,NA,-Split-,NA,1000,34816.85
,,,1/24/2021,Journal Entry,10578,SUN 210124,NA,NA,NA,-Split-,NA,45,34861.85
,,,1/31/2021,Journal Entry,10582,SUNC 210131,NA,NA,NA,-Split-,NA,325,35186.85
,,,2/1/2021,Journal Entry,11028,GC FEB 2021,NA,NA,NA,-Split-,NA,1445,36631.85
,,,2/3/2021,Journal Entry,10583,MD 210203,NA,NA,NA,-Split-,NA,145,36776.85
,,,2/7/2021,Journal Entry,10783,SUN 210207,NA,NA,NA,-Split-,NA,454,37230.85
,,,2/11/2021,Journal Entry,11024,md210211,NA,NA,NA,-Split-,NA,120,37350.85
,,,2/14/2021,Journal Entry,10799,SUN210214,NA,NA,NA,-Split-,NA,480,37830.85
,,,2/19/2021,Journal Entry,11025,MD210219,NA,NA,NA,-Split-,NA,65,37895.85
,,,2/21/2021,Journal Entry,10800,SUN210221,NA,NA,NA,-Split-,NA,35,37930.85
,,,2/23/2021,Journal Entry,11026,MD210223,NA,NA,NA,-Split-,NA,500,38430.85
,,,2/24/2021,Journal Entry,11027,MD210224,NA,NA,NA,-Split-,NA,90,38520.85
,,,2/28/2021,Journal Entry,10802,SUN210228,NA,NA,NA,-Split-,NA,120,38640.85
101.29B Kate Henn Fund,624,,,,,,,,,,,,
,,134272.52,,,,,,,,,,,
101.29C Morningstar Schol Fund,686,,,,,,,,,,,,
,,8019.01,,,,,,,,,,,
101.29D General Schol Fund,625,,,,,,,,,,,,
,,5893.32,,,,,,,,,,,
101.29E IC School Reserve Fund,666,,,,,,,,,,,,
,,34000,,,,,,,,,,,
,,,1/1/2021,Journal Entry,10581,GC 210101,NA,NA,NA,-Split-,NA,805,34805
101.29F IC Parish Reserve Fund,626,,,,,,,,,,,,
,,1800,,,,,,,,,,,
1101.30 Men's Club,687,,,,,,,,,,,,
,,25,,,,,,,,,,,
1103 St. Joseph School Ck Acct #2145,707,,,,,,,,,,,,
1103.10 School Available,NA,,,,,,,,,,,,
,,-8044.25,,,,,,,,,,,
1103.20 School Restricted,590,,,,,,,,,,,,
,,9419.7,,,,,,,,,,,
1106 Old St. Joseph Accounts,330,,,,,,,,,,,,
1106.01 St. Joseph #XXXX Oper (Old) BMO,NA,,,,,,,,,,,,
,,93337.54,,,,,,,,,,,
,,,1/6/2021,Deposit,4452,NA,NA,NA,WS,-Split-,NA,89.01,93426.55
1107 Old St. Francis Xavier Accounts,332,,,,,,,,,,,,
1107.01 St. Francis Xavier Ckg #0396,NA,,,,,,,,,,,,
,,194497.63,,,,,,,,,,,
,,,1/4/2021,Deposit,4447,NA,NA,NA,Interest,3506 Interest & Investment Income:Interest-Checking Accounts,148,1.45,194499.08
,,,1/15/2021,Check,8979,NA,NA,NA,Service Charge,4158 Administrative Expenses:Bank Fees,386,-124.79,194374.29
,,,4/16/2021,Transfer,11032,NA,NA,NA,Unmatched account balances upon import from Desktop,1107.02 Cash:Old St. Francis Xavier Accounts:St Francis Xavier EGiving #0640,333,-250000,-55625.71
1107.02 St Francis Xavier EGiving #0640,333,,,,,,,,,,,,
,,36055.3,,,,,,,,,,,
,,,1/31/2021,Deposit,4050,NA,NA,NA,Interest,3507 Interest & Investment Income:Other Interest Account,45,0.62,36055.92
,,,2/28/2021,Deposit,4051,NA,NA,NA,Interest,3507 Interest & Investment Income:Other Interest Account,45,0.21,36056.13
,,,4/16/2021,Transfer,11032,NA,NA,NA,Unmatched account balances upon import from Desktop,1107.01 Cash:Old St. Francis Xavier Accounts:St. Francis Xavier Ckg #0396,332,250000,286056.13
1107.03 SFX NSCB CCA #3292,334,,,,,,,,,,,,
,,47160.01,,,,,,,,,,,
1107.04 SFX NSCB CCB #5323,448,,,,,,,,,,,,
,,26734.56,,,,,,,,,,,
1107.05 SFX Local TTWCI #4533,335,,,,,,,,,,,,
,,40019.1,,,,,,,,,,,
1107.06 St Francis Xavier RE Ckg #0528,336,,,,,,,,,,,,
,,353.61,,,,,,,,,,,
1107.07 SFX Action #0990,337,,,,,,,,,,,,
,,6597.36,,,,,,,,,,,
1107.09 St Francis Xavier Stipend #0437,339,,,,,,,,,,,,
,,577.07,,,,,,,,,,,
1107.10 St Francis Xavier Endowmnt#7020,340,,,,,,,,,,,,
,,4808.92,,,,,,,,,,,
1107.11 St Francis Xavier Scholar #5782,341,,,,,,,,,,,,
,,218780.43,,,,,,,,,,,
1107.12 StFrancis Xavier Sch EPIC #1686,342,,,,,,,,,,,,
,,432786.04,,,,,,,,,,,
1107.14 SFX Special Collections#0728,488,,,,,,,,,,,,
107.14A Need to Define Restrictions,NA,,,,,,,,,,,,
,,60900.74,,,,,,,,,,,
107.14B Haiti - IC (deleted),489,,,,,,,,,,,,
,,-440,,,,,,,,,,,
107.14C St. Thomas,490,,,,,,,,,,,,
,,13667,,,,,,,,,,,
107.14D St. Thomas Food Pantry,491,,,,,,,,,,,,
,,2000,,,,,,,,,,,
107.14E St. Thomas Schol,492,,,,,,,,,,,,
,,9599,,,,,,,,,,,
107.14F St. Thomas Fall Fest,493,,,,,,,,,,,,
,,50,,,,,,,,,,,
107.14G St. Thomas School,494,,,,,,,,,,,,
,,2832,,,,,,,,,,,
107.14I Funds No Longer Restricted,553,,,,,,,,,,,,
,,3417,,,,,,,,,,,
1107.15 SFX PREP Paypal Acct,593,,,,,,,,,,,,
,,249.74,,,,,,,,,,,
1130 Auxiliary Accounts,268,,,,,,,,,,,,
1131 Saints JFX Aux Accts #3238,NA,,,,,,,,,,,,
,,100,,,,,,,,,,,
1132 St Joseph Auxiliary Accounts,313,,,,,,,,,,,,
1132.01 St Joseph PSO Ckg #9783,NA,,,,,,,,,,,,
,,32484.15,,,,,,,,,,,
1132.02 St Joseph Men's Club #9953,314,,,,,,,,,,,,
,,201.29,,,,,,,,,,,
,,,1/19/2021,Transfer,4505,NA,NA,NA,transfer debit,1101 Cash:Saints JFX Oper. Acct. #2264,565,22.83,224.12
1132.05 St Joseph Women's Club #7028,317,,,,,,,,,,,,
,,16942.44,,,,,,,,,,,
1132.06 St Joseph Legion of Mary #XXXX,318,,,,,,,,,,,,
,,355,,,,,,,,,,,
1132.07 SJS Annual Fund #9598,319,,,,,,,,,,,,
,,10250.44,,,,,,,,,,,
1132.08 SJS PSO Savings #4924,320,,,,,,,,,,,,
,,15073.43,,,,,,,,,,,
1133 St Francis Xavier Auxiliary,344,,,,,,,,,,,,
1133.01 SFX St. Vincent De Paul #2726,NA,,,,,,,,,,,,
,,33277,,,,,,,,,,,
1133.02 SFX School Milk Fund #9852,345,,,,,,,,,,,,
,,20972.42,,,,,,,,,,,
1133.03 SFX School #6212 (local School),437,,,,,,,,,,,,
,,19302.41,,,,,,,,,,,
1133.04 SFX Parish #5323,438,,,,,,,,,,,,
,,26969.03,,,,,,,,,,,
1133.05 SFX School 8th Grade #7570,439,,,,,,,,,,,,
,,11800.48,,,,,,,,,,,
1133.06 SFX (PC) Fun Run #5215 (Church),440,,,,,,,,,,,,
,,5000.46,,,,,,,,,,,
1133.08 SFX School H&S/Script#5681,442,,,,,,,,,,,,
,,61597.09,,,,,,,,,,,
1133.09 SFX School #0847,447,,,,,,,,,,,,
,,36499.62,,,,,,,,,,,
1133.10 SFX School Athletics#4324,519,,,,,,,,,,,,
,,20790.45,,,,,,,,,,,
1133.12 SFX HSA Chk#1731,521,,,,,,,,,,,,
,,729.26,,,,,,,,,,,
1133.14 SFX Womens Club#6641,523,,,,,,,,,,,,
,,1354.51,,,,,,,,,,,
1133.16 SFX Boy Scouts #0611,525,,,,,,,,,,,,
,,87.1,,,,,,,,,,,
1133.17 SFX Faith Alive #3549,526,,,,,,,,,,,,
,,906.89,,,,,,,,,,,
1133.18 Peace and Justic #3536,552,,,,,,,,,,,,
,,609.47,,,,,,,,,,,
1150 Petty Cash Account,510,,,,,,,,,,,,
1150.02 SJ Petty Cash,NA,,,,,,,,,,,,
,,258,,,,,,,,,,,
1200 Oper. Savings at the Arch Bank,556,,,,,,,,,,,,
1201 Regular Operating Savings,NA,,,,,,,,,,,,
1201.01 SSJFX Reg Savings 701435201,NA,,,,,,,,,,,,
,,518.66,,,,,,,,,,,
1201.02 SFX Reg Svgs #701430201,346,,,,,,,,,,,,
,,14000.19,,,,,,,,,,,
1210 Certificates of Deposit,356,,,,,,,,,,,,
1212 6 Month CD-Operating Savings,NA,,,,,,,,,,,,
1212.01 StJoseph6Mo Scholarship CD#0597,NA,,,,,,,,,,,,
,,101947.01,,,,,,,,,,,
1240 Stock Savings Account,600,,,,,,,,,,,,
1240.01 SFX Stock/Mut Fund #401430250,NA,,,,,,,,,,,,
,,5804.1,,,,,,,,,,,
1240.02 SFX Stock/Mut Fund #701430250,651,,,,,,,,,,,,
,,66888.69,,,,,,,,,,,
,,,1/21/2021,Deposit,4166,NA,NA,NA,Deposit,-Split-,NA,2479.94,69368.63
,,,1/22/2021,Transfer,4502,NA,NA,NA,transfer from school acct to church acct,1240.04 Oper. Savings at the Arch Bank:Stock Savings Account:StJoseph Stk/Mut Fnd #702440250,601,1593.51,70962.14
,,,1/22/2021,Transfer,4503,NA,NA,NA,transfer capital restricted funds to building account,1301.01 Long-Term/Restricted Savings:Building Fund Savings:SFX Bldg Fund #701430204,347,-29603.48,41358.66
,,,1/29/2021,Transfer,4504,NA,NA,NA,transfer of funds to restricted account,101.25E Cash:Saints JFX Oper. Acct. #2264:Checking Restricted:Church Restricted:SVDP,659,-500,40858.66
1240.03 StJoseph Stk/Mut Fnd #402440250,609,,,,,,,,,,,,
,,2007.19,,,,,,,,,,,
,,,1/21/2021,Deposit,4165,NA,NA,NA,Deposit,3706 Miscellaneous Income:Donations,159,1826.05,3833.24
1240.04 StJoseph Stk/Mut Fnd #702440250,601,,,,,,,,,,,,
,,33316.15,,,,,,,,,,,
,,,1/22/2021,Transfer,4502,NA,NA,NA,transfer from school acct to church acct,1240.02 Oper. Savings at the Arch Bank:Stock Savings Account:SFX Stock/Mut Fund #701430250,651,-1593.51,31722.64
1260 TTWCI Savings Account,599,,,,,,,,,,,,
1260.01 SFX TTWCI #701430260,NA,,,,,,,,,,,,
,,103364.06,,,,,,,,,,,
1260.02 St Joseph TTWCI #702440260,693,,,,,,,,,,,,
,,115080.79,,,,,,,,,,,
1300 Long-Term/Restricted Savings,347,,,,,,,,,,,,
1301 Building Fund Savings,NA,,,,,,,,,,,,
1301.01 SFX Bldg Fund #701430204,NA,,,,,,,,,,,,
,,417886.45,,,,,,,,,,,
,,,1/22/2021,Transfer,4503,NA,NA,NA,transfer capital restricted funds to building account,1240.02 Oper. Savings at the Arch Bank:Stock Savings Account:SFX Stock/Mut Fund #701430250,651,29603.48,447489.93
1301.02 St Joseph Bldg Fund #702440204,348,,,,,,,,,,,,
,,34489.31,,,,,,,,,,,
1350 Stipend Account,353,,,,,,,,,,,,
1350.01 SFX Stipend Acct# 701430202,NA,,,,,,,,,,,,
,,6331.18,,,,,,,,,,,
1400 Endowment & Spc Investment Sav,351,,,,,,,,,,,,
1401 Parish Endowment Fund,NA,,,,,,,,,,,,
1401.01 SFX Parish Endwmt #701430212,NA,,,,,,,,,,,,
,,2217536.16,,,,,,,,,,,
1401.02 StJoseph Endowment #702440212,352,,,,,,,,,,,,
,,414139.4,,,,,,,,,,,
1410 Parish Education Endowment Fund,551,,,,,,,,,,,,
1410.01 SFX School Endwmt #701430211,NA,,,,,,,,,,,,
1410.03 School Endowment (.826),NA,,,,,,,,,,,,
,,796570.25,,,,,,,,,,,
1410.04 Louise Murphy Scholar (.174),550,,,,,,,,,,,,
,,167080.81,,,,,,,,,,,
1420 Growth Mutual Fund,349,,,,,,,,,,,,
1420.01 SFX GowthFund #701430231 (SVDP),NA,,,,,,,,,,,,
,,167889.44,,,,,,,,,,,
1600 Other Current Assets,538,,,,,,,,,,,,
1603 Other Current Assets,NA,,,,,,,,,,,,
1603.30 St. Francis Xavier Other Assets,NA,,,,,,,,,,,,
1603.33 SFX Marketable Security,NA,,,,,,,,,,,,
,,38437.5,,,,,,,,,,,
1603.37 SFX School Technology Fund,618,,,,,,,,,,,,
,,62705.27,,,,,,,,,,,
1603.38 SFX Undesignated Scholar/Proj,662,,,,,,,,,,,,
,,221972.77,,,,,,,,,,,
1603.39 SFX EPIC Proj. Fund,619,,,,,,,,,,,,
,,134244,,,,,,,,,,,
1603.40 SFX School Fund the Need,696,,,,,,,,,,,,
,,302198,,,,,,,,,,,
1603.41 SFX School Teacher Development,620,,,,,,,,,,,,
,,38552.75,,,,,,,,,,,
1603.42 SFX School Events Funds,663,,,,,,,,,,,,
,,33366,,,,,,,,,,,
2000 Accounts Payable,217,,,,,,,,,,,,
,,4679.68,,,,,,,,,,,
,,,1/1/2021,Bill,8384,AR00174984,Catholic Bishop of Chicago (BillingSSJFX),359,NA,4751 Archdiocesan Assessment:Archhdiocesean Assesment,253,19754.24,24433.92
,,,1/1/2021,Bill,8385,AR00175239,Catholic Bishop of Chicago (BillingSSJFX),359,NA,"4752 Archdiocesan Assessment:Lease, Lic & Rental Arch Assess",254,463.5,24897.42
,,,1/1/2021,Bill,8386,AR00175481,Catholic Bishop of Chicago (BillingSSJFX),359,NA,4760 PRMAA Assessment,145,6913.98,31811.4
,,,1/1/2021,Bill,8387,IB00181594,Catholic Bishop of Chicago (BillingSSJFX),359,NA,4030 Health Insurance-Employer Paid,163,14112,45923.4
,,,1/1/2021,Bill,8388,IR00148317,Catholic Bishop of Chicago (BillingSSJFX),359,NA,4052 Fringe Benefits:Fringe Benefits - Lay,186,2337,48260.4
,,,1/1/2021,Bill,8389,MR00157900,Catholic Bishop of Chicago (BillingSSJFX),359,NA,4780 Property/Casualty Insurance,390,4451.64,52712.04
,,,1/1/2021,Bill,8396,MR00157745,Catholic Bishop of Chicago (BillingSJS),547,NA,4780 Property/Casualty Insurance,390,3970.38,56682.42
,,,1/1/2021,Bill,8391,IB00181261,Catholic Bishop of Chicago (BillingSFXS),548,NA,4030 Health Insurance-Employer Paid,163,3024,59706.42
,,,1/1/2021,Bill,8392,IR00148130,Catholic Bishop of Chicago (BillingSFXS),548,NA,4052 Fringe Benefits:Fringe Benefits - Lay,186,6709,66415.42
,,,1/1/2021,Bill,8393,MR00157716,Catholic Bishop of Chicago (BillingSFXS),548,NA,4780 Property/Casualty Insurance,390,3609.44,70024.86
,,,1/1/2021,Bill,8394,IB00181298,Catholic Bishop of Chicago (BillingSJS),547,NA,4030 Health Insurance-Employer Paid,163,5040,75064.86
,,,1/1/2021,Bill,8395,IR00148161,Catholic Bishop of Chicago (BillingSJS),547,NA,4052 Fringe Benefits:Fringe Benefits - Lay,186,614,75678.86
,,,1/1/2021,Bill,8390,IB00181260,Catholic Bishop of Chicago (BillingSFXS),548,NA,4030 Health Insurance-Employer Paid,163,40320,115998.86
,,,1/11/2021,Bill,8372,4034960577,Canon Maintanence,563,NA,4151 Administrative Expenses:Ofc Equipment-Supplies & Maint.,47,15.34,116014.2
,,,1/11/2021,Bill,6577,3784918,Engie Resources SJ Campus,111,NA,-Split-,NA,136.94,116151.14
,,,1/11/2021,Bill,8374,11/26 - 12/27,Nicor SJ Convent,12,NA,4410 Heating Fuel,61,907.46,117058.6
,,,1/11/2021,Bill,8375,Nov - Dec 2020,Bank of America SFX 5830,296,NA,2010.03 Procurement Card Payable:SFXS,611,4815.28,121873.88
,,,1/11/2021,Bill,8376,19-482-251,TelAssist,137,NA,4434 Other Utilities:Internet/Computer Telecom Costs,66,94.92,121968.8
,,,1/11/2021,Bill,8370,145403,GO Technology Group Inc.,64,NA,4702 Furnishings & Equipment:Instructional Furnishings/Equip,133,5345,127313.8
,,,1/11/2021,Bill,8371,145450,GO Technology Group Inc.,64,NA,4155 Administrative Expenses:Professional Service Fees,51,1600,128913.8
,,,1/11/2021,Bill,6588,746066,Anderson Lock,185,NA,4451 Maintenance & Building Repairs:Security,68,16.36,128930.16
,,,1/11/2021,Bill,6589,121548,Elk Grove Graphics,485,NA,4152 Administrative Expenses:Outside Printing Cost,48,991.98,129922.14
,,,1/11/2021,Bill,6590,22295498,Canon SFX,524,contract 0010491764245,4701 Furnishings & Equipment:Admin Furnishings/Equip,132,234,130156.14
,,,1/11/2021,Bill,6591,9502,Wilshore Electric LLC,872,NA,4451 Maintenance & Building Repairs:Security,68,644,130800.14
,,,1/11/2021,Bill,6592,705624-01,Watra Church Goods,350,NA,4660 Altar & Liturgical Supplies:Other Liturgical Costs,127,11.5,130811.64
,,,1/11/2021,Bill,6578,3784941,Engie Resources Convent SJ,112,NA,-Split-,NA,9.86,130821.5
,,,1/11/2021,Bill,6579,RR Rodlin wages,St. Joan of Arc,870,NA,4011 Salaries:Priests,638,1263.58,132085.08
,,,1/11/2021,Bill,6580,107188,Monk's WIne and Candles SSJFX,65,NA,4653 Altar & Liturgical Supplies:Candles,123,98.8,132183.88
,,,1/11/2021,Bill,6581,8060733105,Staples SJ,92,NA,-Split-,NA,1431.46,133615.34
,,,1/11/2021,Bill,6582,638413,Village of Wilmette SJ Annex 330900,830,NA,4431 Other Utilities:Water/Sewer,63,820.5,134435.84
,,,1/11/2021,Bill,6583,1738171-03,"Kranz, Inc",415,NA,4459 Maintenance & Building Repairs:Janitorial Supplies,118,355.44,134791.28
,,,1/11/2021,Bill,6584,cantor Christmas Eve,Bonnie Mootry,871,NA,4015 Salaries:Admin Support Staff - Church,397,100,134891.28
,,,1/11/2021,Vendor Credit,6585,SFX92120,Heinemann,405,NA,"4105 Books & Supplies,Non-Liturgical:Textbooks",561,-180,134711.28
,,,1/11/2021,Bill,6586,Jan 1 - Feb 1 2021,Comcast Business (TV) SFXS 1576,57,NA,4433 Other Utilities:Cable/Dish Services,65,5.04,134716.32
,,,1/11/2021,Bill,6587,1002,Merbeth Metal Products Inc,866,NA,6063 Other Extraordinary Expenses:Other Extraordinary Expenses,637,580,135296.32
,,,1/11/2021,Bill,6569,107211,Monk's WIne and Candles SSJFX,65,NA,-Split-,NA,177.26,135473.58
,,,1/11/2021,Bill,6570,1372,Americhoice Radon Testing,869,NA,4155 Administrative Expenses:Professional Service Fees,51,500,135973.58
,,,1/11/2021,Bill,6571,AE12053296,Apple Inc.,846,NA,4702 Furnishings & Equipment:Instructional Furnishings/Equip,133,5310,141283.58
,,,1/11/2021,Bill,6572,MAT-182049,A SmartSign Store,567,NA,4154 Administrative Expenses:Office Supplies,50,635.36,141918.94
,,,1/11/2021,Bill,6573,110952012,Accurate Biometrics,24,NA,4157 Administrative Expenses:Criminal Background Checks,52,46.5,141965.44
,,,1/11/2021,Bill,6574,RR Costco member,Joseph D'Arco,45,NA,4807 Miscellaneous:Dues/Subscriptions,137,360,142325.44
,,,1/11/2021,Bill,6575,RR heaters at SFXS,Mike Henn,79,NA,6063 Other Extraordinary Expenses:Other Extraordinary Expenses,637,2090.5,144415.94
,,,1/11/2021,Bill,6576,RR barrel shipping,Mike Henn,79,NA,6016C Sharing Outside the AOC:Immaculate Conception-Haiti:IC Parish Support,544,4060,148475.94
,,,1/11/2021,Bill,8373,4034960578,Canon Maintanence,563,NA,4151 Administrative Expenses:Ofc Equipment-Supplies & Maint.,47,93.26,148569.2
,,,1/12/2021,Bill,8377,T40002536325,Advanced Disposal SJ CH,108,NA,4432 Other Utilities:Scavenger Service,64,429.81,148999.01
,,,1/12/2021,Bill,8082,3799341,Engie Resources SJ Campus,111,NA,-Split-,NA,1781.59,150780.6
,,,1/12/2021,Bill,8379,RR spirit/psalms,John Hopkins,101,NA,4656 Altar & Liturgical Supplies:Music Books,126,55.67,150836.27
,,,1/12/2021,Bill,8380,RR music/office exp,John Hopkins,101,NA,-Split-,NA,93.16,150929.43
,,,1/12/2021,Bill,8381,reissue bonus chk,Edward Harnett,121,NA,4806 Miscellaneous:Gifts & Donations,139,400,151329.43
,,,1/12/2021,Bill,8382,donation,To Teach Who Christ Is,559,NA,"5115.02 Fund Collections:""To Teach Who Christ Is"" Campgn:St Francis Xavier TTWCI Campagn",431,50000,201329.43
,,,1/12/2021,Bill,8383,thru 2/5/2021,Chicago Tribune,222,acct: 30043892,4807 Miscellaneous:Dues/Subscriptions,137,139.16,201468.59
,,,1/12/2021,Bill,8083,22295612,Canon,258,NA,-Split-,NA,1522,202990.59
,,,1/12/2021,Bill,8062,Jan 2021 statement,Comcast SFX Rectory 2307,170,NA,4433 Other Utilities:Cable/Dish Services,65,232.75,203223.34
,,,1/12/2021,Bill,8063,2469878507,AT&T SJS,235,NA,4400 Telephone,60,163.62,203386.96
,,,1/12/2021,Bill,8064,2454978502,AT&T SFX ALL 5570 631,169,NA,-Split-,NA,798.92,204185.88
,,,1/12/2021,Bill,8065,12/20-1/16/21,The New York Times,140,NA,4807 Miscellaneous:Dues/Subscriptions,137,54,204239.88
,,,1/12/2021,Bill,8066,2447978501,AT&T SJC 395,25,NA,4400 Telephone,60,93.78,204333.66
,,,1/12/2021,Bill,8067,Nov 20 - Dec 19,AT&T SJC YFF 2253,448,NA,4400 Telephone,60,74.62,204408.28
,,,1/12/2021,Bill,8068,9869406380,Verizon Wireless,118,NA,-Split-,NA,88.1,204496.38
,,,1/12/2021,Bill,8069,40611,Precision,93,NA,4459 Maintenance & Building Repairs:Janitorial Supplies,118,376,204872.38
,,,1/12/2021,Bill,8070,40727,Precision,93,NA,4454 Maintenance & Building Repairs:Building Services,71,1491,206363.38
,,,1/12/2021,Bill,8071,INV99812,Learning Without Tears,404,NA,"4109 Books & Supplies,Non-Liturgical:Instructional Materials",563,22.7,206386.08
,,,1/12/2021,Bill,8072,271872020B000,Metropolitan Water Reclamation District,518,NA,4431 Other Utilities:Water/Sewer,63,674.79,207060.87
,,,1/12/2021,Bill,8073,MA December,Daniel Mayall,85,NA,4253 Food Service & Meals:Meal Allowance,57,63,207123.87
,,,1/12/2021,Bill,8074,271962020B000,Metropolitan Water Reclamation District,518,NA,4431 Other Utilities:Water/Sewer,63,324.1,207447.97
,,,1/12/2021,Bill,8075,RR reprint from 12/7,John Hopkins,101,NA,-Split-,NA,108.43,207556.4
,,,1/12/2021,Bill,8076,37,Ron's Artic Snowplowing,304,NA,-Split-,NA,6341.25,213897.65
,,,1/12/2021,Bill,8077,covid shields,James Bui,873,NA,6063 Other Extraordinary Expenses:Other Extraordinary Expenses,637,200,214097.65
,,,1/12/2021,Bill,8078,RR tuition overpaid,Eileen and Kevin O'Hara,874,NA,3101 Tuition:Tuition - Current,698,800,214897.65
,,,1/12/2021,Bill,8079,113790861,Comcast Business (Internet) SJS 5239,851,NA,4434 Other Utilities:Internet/Computer Telecom Costs,66,293.35,215191
,,,1/12/2021,Bill,8080,MJ12010733,Lapels of Wilmette SJC,426,NA,4155 Administrative Expenses:Professional Service Fees,51,60,215251
,,,1/12/2021,Bill,8081,3799271,Engie Resources Convent SJ,112,NA,4420 Electricity,62,123.7,215374.7
,,,1/12/2021,Bill,8060,Feb 2021 statement,Pitney Bowes Purchase Power SFXCH 6704,806,NA,4153 Administrative Expenses:Postage/Courier Services,49,534.85,215909.55
,,,1/12/2021,Bill,8061,RR Christmas gift,Wayne Watts,241,NA,-Split-,NA,6095.84,222005.39
,,,1/12/2021,Bill,8378,T40002535551,Advanced Disposal SFX Sch,60,NA,4432 Other Utilities:Scavenger Service,64,457.03,222462.42
,,,1/13/2021,Bill Payment (Check),2819,3951,Mike Henn,79,NA,101.29A Cash:Saints JFX Oper. Acct. #2264:Checking Restricted:Haiti:Haiti General Fund,697,-4060,218402.42
,,,1/13/2021,Bill Payment (Check),2820,3950,To Teach Who Christ Is,559,NA,101.25G Cash:Saints JFX Oper. Acct. #2264:Checking Restricted:Church Restricted:TTWCI,665,-50000,168402.42
,,,1/13/2021,Bill Payment (Check),2761,3892,A SmartSign Store,567,NA,1101.10 Cash:Saints JFX Oper. Acct. #2264:Checking Available,691,-635.36,167767.06
,,,1/13/2021,Bill Payment (Check),2762,3893,Accurate Biometrics,24,NA,1101.10 Cash:Saints JFX Oper. Acct. #2264:Checking Available,691,-46.5,167720.56
,,,1/13/2021,Bill Payment (Check),2763,3894,Advanced Disposal SFX CH,59,NA,1101.10 Cash:Saints JFX Oper. Acct. #2264:Checking Available,691,-157.05,167563.51
,,,1/13/2021,Bill Payment (Check),2764,3895,Advanced Disposal SFX Sch,60,NA,1101.10 Cash:Saints JFX Oper. Acct. #2264:Checking Available,691,-457.03,167106.48
,,,1/13/2021,Bill Payment (Check),2765,3896,Advanced Disposal SJ CH,108,NA,1101.10 Cash:Saints JFX Oper. Acct. #2264:Checking Available,691,-429.81,166676.67
,,,1/13/2021,Bill Payment (Check),2766,3897,Americhoice Radon Testing,869,NA,1101.10 Cash:Saints JFX Oper. Acct. #2264:Checking Available,691,-500,166176.67
,,,1/13/2021,Bill Payment (Check),2767,3898,Anderson Lock,185,NA,1101.10 Cash:Saints JFX Oper. Acct. #2264:Checking Available,691,-16.36,166160.31
,,,1/13/2021,Bill Payment (Check),2768,3899,Apple Inc.,846,NA,1101.10 Cash:Saints JFX Oper. Acct. #2264:Checking Available,691,-5310,160850.31
,,,1/13/2021,Bill Payment (Check),2769,3900,AT&T Messaging SFX CH,71,NA,1101.10 Cash:Saints JFX Oper. Acct. #2264:Checking Available,691,-14.95,160835.36
,,,1/13/2021,Bill Payment (Check),2770,3901,AT&T SFX ALL 5570 631,169,NA,1101.10 Cash:Saints JFX Oper. Acct. #2264:Checking Available,691,-798.92,160036.44
,,,1/13/2021,Bill Payment (Check),2771,3902,AT&T SJC 395,25,NA,1101.10 Cash:Saints JFX Oper. Acct. #2264:Checking Available,691,-93.78,159942.66
,,,1/13/2021,Bill Payment (Check),2772,3903,AT&T SJC YFF 2253,448,NA,1101.10 Cash:Saints JFX Oper. Acct. #2264:Checking Available,691,-74.62,159868.04
,,,1/13/2021,Bill Payment (Check),2773,3904,AT&T SJS,235,NA,1101.10 Cash:Saints JFX Oper. Acct. #2264:Checking Available,691,-163.62,159704.42
,,,1/13/2021,Bill Payment (Check),2774,3905,Bank of America SFX 5830,296,NA,1101.10 Cash:Saints JFX Oper. Acct. #2264:Checking Available,691,-4815.28,154889.14
,,,1/13/2021,Bill Payment (Check),2775,3906,Bonnie Mootry,871,NA,1101.10 Cash:Saints JFX Oper. Acct. #2264:Checking Available,691,-100,154789.14
,,,1/13/2021,Bill Payment (Check),2776,3907,Canon,258,NA,1101.10 Cash:Saints JFX Oper. Acct. #2264:Checking Available,691,-1522,153267.14
,,,1/13/2021,Bill Payment (Check),2777,3908,Canon Maintanence,563,NA,1101.10 Cash:Saints JFX Oper. Acct. #2264:Checking Available,691,-108.6,153158.54
,,,1/13/2021,Bill Payment (Check),2778,3909,Canon SFX,524,NA,1101.10 Cash:Saints JFX Oper. Acct. #2264:Checking Available,691,-234,152924.54
,,,1/13/2021,Bill Payment (Check),2779,3910,Catholic Bishop of Chicago (BillingSFXS),548,NA,1101.10 Cash:Saints JFX Oper. Acct. #2264:Checking Available,691,-53662.44,99262.1
,,,1/13/2021,Bill Payment (Check),2780,3911,Catholic Bishop of Chicago (BillingSSJFX),359,NA,1101.10 Cash:Saints JFX Oper. Acct. #2264:Checking Available,691,-48032.36,51229.74
,,,1/13/2021,Bill Payment (Check),2781,3912,Chicago Tribune,222,NA,1101.10 Cash:Saints JFX Oper. Acct. #2264:Checking Available,691,-139.16,51090.58
,,,1/13/2021,Bill Payment (Check),2782,3913,Comcast Business (Internet) SJS 5239,851,NA,1101.10 Cash:Saints JFX Oper. Acct. #2264:Checking Available,691,-293.35,50797.23
,,,1/13/2021,Bill Payment (Check),2783,3914,Comcast SFX Rectory 2307,170,NA,1101.10 Cash:Saints JFX Oper. Acct. #2264:Checking Available,691,-232.75,50564.48
,,,1/13/2021,Bill Payment (Check),2784,3915,Comcast Business (TV) SFXS 1576,57,NA,1101.10 Cash:Saints JFX Oper. Acct. #2264:Checking Available,691,-5.04,50559.44
,,,1/13/2021,Bill Payment (Check),2785,3916,Daniel Mayall,85,NA,1101.10 Cash:Saints JFX Oper. Acct. #2264:Checking Available,691,-63,50496.44
,,,1/13/2021,Bill Payment (Check),2786,3917,Edward Harnett,121,NA,1101.10 Cash:Saints JFX Oper. Acct. #2264:Checking Available,691,-400,50096.44
,,,1/13/2021,Bill Payment (Check),2787,3918,Eileen and Kevin O'Hara,874,NA,1101.10 Cash:Saints JFX Oper. Acct. #2264:Checking Available,691,-800,49296.44
,,,1/13/2021,Bill Payment (Check),2788,3919,Elk Grove Graphics,485,NA,1101.10 Cash:Saints JFX Oper. Acct. #2264:Checking Available,691,-991.98,48304.46
,,,1/13/2021,Bill Payment (Check),2789,3920,Engie Resources Convent SJ,112,NA,1101.10 Cash:Saints JFX Oper. Acct. #2264:Checking Available,691,-133.56,48170.9
,,,1/13/2021,Bill Payment (Check),2790,3921,Engie Resources SJ Campus,111,NA,1101.10 Cash:Saints JFX Oper. Acct. #2264:Checking Available,691,-1918.53,46252.37
,,,1/13/2021,Bill Payment (Check),2791,3922,Engie SFX,253,NA,1101.10 Cash:Saints JFX Oper. Acct. #2264:Checking Available,691,-276.69,45975.68
,,,1/13/2021,Bill Payment (Check),2792,3923,GO Technology Group Inc.,64,NA,1101.10 Cash:Saints JFX Oper. Acct. #2264:Checking Available,691,-6945,39030.68
,,,1/13/2021,Bill Payment (Check),2793,3924,Janina Jakucewicz,138,NA,1101.10 Cash:Saints JFX Oper. Acct. #2264:Checking Available,691,-229.08,38801.6
,,,1/13/2021,Bill Payment (Check),2794,3925,"Kranz, Inc",415,NA,1101.10 Cash:Saints JFX Oper. Acct. #2264:Checking Available,691,-355.44,38446.16
,,,1/13/2021,Bill Payment (Check),2795,3926,Lapels of WIlmette SFX Rectory Cleaning,58,NA,1101.10 Cash:Saints JFX Oper. Acct. #2264:Checking Available,691,-24,38422.16
,,,1/13/2021,Bill Payment (Check),2796,3927,Lapels of Wilmette SJC,426,NA,1101.10 Cash:Saints JFX Oper. Acct. #2264:Checking Available,691,-60,38362.16
,,,1/13/2021,Bill Payment (Check),2797,3928,Learning Without Tears,404,NA,1101.10 Cash:Saints JFX Oper. Acct. #2264:Checking Available,691,-22.7,38339.46
,,,1/13/2021,Bill Payment (Check),2798,3929,Metropolitan Water Reclamation District,518,NA,1101.10 Cash:Saints JFX Oper. Acct. #2264:Checking Available,691,-998.89,37340.57
,,,1/13/2021,Bill Payment (Check),2799,3930,Monk's WIne and Candles SSJFX,65,NA,1101.10 Cash:Saints JFX Oper. Acct. #2264:Checking Available,691,-276.06,37064.51
,,,1/13/2021,Bill Payment (Check),2800,3931,Morning Glory Flower Shop,55,NA,1101.10 Cash:Saints JFX Oper. Acct. #2264:Checking Available,691,-89,36975.51
,,,1/13/2021,Bill Payment (Check),2801,3932,Nicor SJ Convent,12,NA,1101.10 Cash:Saints JFX Oper. Acct. #2264:Checking Available,691,-907.46,36068.05
,,,1/13/2021,Bill Payment (Check),2802,3933,Pitney Bowes Purchase Power SFXCH 6704,806,NA,1101.10 Cash:Saints JFX Oper. Acct. #2264:Checking Available,691,-534.85,35533.2
,,,1/13/2021,Bill Payment (Check),2803,3934,Ron's Artic Snowplowing,304,NA,1101.10 Cash:Saints JFX Oper. Acct. #2264:Checking Available,691,-6341.25,29191.95
,,,1/13/2021,Bill Payment (Check),2804,3935,St. Joan of Arc,870,NA,1101.10 Cash:Saints JFX Oper. Acct. #2264:Checking Available,691,-1263.58,27928.37
,,,1/13/2021,Bill Payment (Check),2805,3936,Staples SJ,92,NA,1101.10 Cash:Saints JFX Oper. Acct. #2264:Checking Available,691,-1431.46,26496.91
,,,1/13/2021,Bill Payment (Check),2806,3937,TelAssist,137,NA,1101.10 Cash:Saints JFX Oper. Acct. #2264:Checking Available,691,-94.92,26401.99
,,,1/13/2021,Bill Payment (Check),2807,3938,The New York Times,140,NA,1101.10 Cash:Saints JFX Oper. Acct. #2264:Checking Available,691,-54,26347.99
,,,1/13/2021,Bill Payment (Check),2808,3939,Verizon Wireless,118,NA,1101.10 Cash:Saints JFX Oper. Acct. #2264:Checking Available,691,-88.1,26259.89
,,,1/13/2021,Bill Payment (Check),2809,3940,Village of Wilmette SJ Annex 330900,830,NA,1101.10 Cash:Saints JFX Oper. Acct. #2264:Checking Available,691,-820.5,25439.39
,,,1/13/2021,Bill Payment (Check),2810,3941,Watra Church Goods,350,NA,1101.10 Cash:Saints JFX Oper. Acct. #2264:Checking Available,691,-11.5,25427.89
,,,1/13/2021,Bill Payment (Check),2811,3942,Wayne Watts,241,NA,1101.10 Cash:Saints JFX Oper. Acct. #2264:Checking Available,691,-6095.84,19332.05
,,,1/13/2021,Bill Payment (Check),2812,3943,Wilshore Electric LLC,872,NA,1101.10 Cash:Saints JFX Oper. Acct. #2264:Checking Available,691,-2384,16948.05
,,,1/13/2021,Bill Payment (Check),2813,3944,James Bui,873,NA,1101.10 Cash:Saints JFX Oper. Acct. #2264:Checking Available,691,-200,16748.05
,,,1/13/2021,Bill Payment (Check),2814,3945,John Hopkins,101,NA,1101.10 Cash:Saints JFX Oper. Acct. #2264:Checking Available,691,-257.26,16490.79
,,,1/13/2021,Bill Payment (Check),2815,3946,Joseph D'Arco,45,NA,1101.10 Cash:Saints JFX Oper. Acct. #2264:Checking Available,691,-360,16130.79
,,,1/13/2021,Bill Payment (Check),2816,3947,Merbeth Metal Products Inc,866,NA,1101.10 Cash:Saints JFX Oper. Acct. #2264:Checking Available,691,-580,15550.79
,,,1/13/2021,Bill Payment (Check),2817,3948,Mike Henn,79,NA,1101.10 Cash:Saints JFX Oper. Acct. #2264:Checking Available,691,-2090.5,13460.29
,,,1/13/2021,Bill Payment (Check),2818,3949,Precision,93,NA,1101.10 Cash:Saints JFX Oper. Acct. #2264:Checking Available,691,-1867,11593.29
,,,1/13/2021,Bill,8398,7572301,AT&T Messaging SFX CH,71,NA,4400 Telephone,60,14.95,11608.24
,,,1/13/2021,Bill,8399,MJ12010330,Lapels of WIlmette SFX Rectory Cleaning,58,NA,4155 Administrative Expenses:Professional Service Fees,51,24,11632.24
,,,1/13/2021,Bill,8400,271821,Morning Glory Flower Shop,55,NA,4659 Altar & Liturgical Supplies:Flowers,130,89,11721.24
,,,1/13/2021,Bill,8401,T40002530908,Advanced Disposal SFX CH,59,NA,4432 Other Utilities:Scavenger Service,64,157.05,11878.29
,,,1/13/2021,Bill,8402,9511,Wilshore Electric LLC,872,NA,4455 Maintenance & Building Repairs:Repairs to Buildings,115,1740,13618.29
,,,1/13/2021,Bill,8403,RR supplies,Janina Jakucewicz,138,NA,4459 Maintenance & Building Repairs:Janitorial Supplies,118,229.08,13847.37
,,,1/13/2021,Bill,8404,3784858,Engie SFX,253,NA,-Split-,NA,276.69,14124.06
,,,1/22/2021,Bill Payment (Check),2699,3952,Jennifer Henik,876,NA,1101.10 Cash:Saints JFX Oper. Acct. #2264:Checking Available,691,-196.31,13927.75
,,,1/22/2021,Bill,8405,1/8/2021 retro pay,Jennifer Henik,876,Fed8.31/Med3.39/SS14.51/IL11.58/Gross234.00,4015 Salaries:Admin Support Staff - Church,397,196.31,14124.06
,,,1/25/2021,Bill,8407,IN00409279,Fox Valley Fire and Safety,269,NA,4456 Maintenance & Building Repairs:Equipment Services,116,337,14461.06
,,,1/25/2021,Bill,8406,428624,Church Budget,28,NA,4152 Administrative Expenses:Outside Printing Cost,48,601.18,15062.24
,,,1/25/2021,Bill,8409,3702,Sparks Interior LTD,877,NA,4701 Furnishings & Equipment:Admin Furnishings/Equip,132,899,15961.24
,,,1/25/2021,Bill,8410,41,Ron's Artic Snowplowing,304,NA,-Split-,NA,6341.25,22302.49
,,,1/25/2021,Bill,8411,2021-STFX-5,"Fun Fluency, Inc",509,NA,-Split-,NA,6515,28817.49
,,,1/25/2021,Bill,8412,1056874,Anderson Lock,185,NA,4451 Maintenance & Building Repairs:Security,68,16.36,28833.85
,,,1/25/2021,Bill,8413,SW20926,Martin Peterson Company Inc.,353,NA,4455 Maintenance & Building Repairs:Repairs to Buildings,115,3050,31883.85
,,,1/25/2021,Bill,8414,SW20927,Martin Peterson Company Inc.,353,NA,4455 Maintenance & Building Repairs:Repairs to Buildings,115,8140,40023.85
,,,1/25/2021,Bill,8415,Jan statement,Albertsons/Safeway,156,NA,4252 Food Service & Meals:Food/Groceries,56,908.65,40932.5
,,,1/25/2021,Bill,8416,5350499507,AT&T SJS,235,NA,4400 Telephone,60,334.65,41267.15
,,,1/25/2021,Bill,8417,5338499503,AT&T SJC 395,25,NA,4400 Telephone,60,188.83,41455.98
,,,1/25/2021,Bill,8418,10573050-00,"Active Electrical Supply Co., Inc",107,NA,4459 Maintenance & Building Repairs:Janitorial Supplies,118,21.48,41477.46
,,,1/25/2021,Bill,8419,68636,Crescent Cleaning Company,820,NA,-Split-,NA,17629.19,59106.65
,,,1/25/2021,Bill,8420,68122,Crescent Cleaning Company,820,NA,-Split-,NA,11254.19,70360.84
,,,1/25/2021,Bill,8421,RR stamps,Anne Hrabe,878,NA,4153 Administrative Expenses:Postage/Courier Services,49,660,71020.84
,,,1/25/2021,Bill,8422,IB00181483,The Catholic Bishop of Chicago,230,NA,4030 Health Insurance-Employer Paid,163,38.5,71059.34
,,,1/25/2021,Bill,8423,RI104746791,FP Mailing Solutions,114,NA,4701 Furnishings & Equipment:Admin Furnishings/Equip,132,95.34,71154.68
,,,1/25/2021,Bill,8424,13679,Berghaus,270,NA,4456 Maintenance & Building Repairs:Equipment Services,116,215.65,71370.33
,,,1/25/2021,Bill,8425,3798378,Engie SFX,253,NA,-Split-,NA,8695.25,80065.58
,,,1/25/2021,Bill,8426,94146049/94166105,OCP,475,NA,4656 Altar & Liturgical Supplies:Music Books,126,283.32,80348.9
,,,1/25/2021,Bill,8427,bal due,Gospel Weeklies,237,NA,"4106 Books & Supplies,Non-Liturgical:Workbooks",688,85.22,80434.12
,,,1/25/2021,Bill,8428,Helen PreJean talk,Ministry Against the Death Penalty,817,NA,4802 Miscellaneous:Meetings & Speakers,140,250,80684.12
,,,1/25/2021,Bill,8429,RR Mixer for loft,Jonathan Metzinger,438,NA,4701 Furnishings & Equipment:Admin Furnishings/Equip,132,209.99,80894.11
,,,1/25/2021,Bill,8430,7016248,Loyola Press YFF,833,NA,"4105 Books & Supplies,Non-Liturgical:Textbooks",561,3938.42,84832.53
,,,1/25/2021,Bill,8431,19-642-471,TelAssist,137,NA,4434 Other Utilities:Internet/Computer Telecom Costs,66,99.34,84931.87
,,,1/25/2021,Bill,8432,Donation,Catholic Extension,879,NA,4806 Miscellaneous:Gifts & Donations,139,1000,85931.87
,,,1/25/2021,Bill,8433,9871519103,Verizon Wireless,118,NA,-Split-,NA,93.25,86025.12
,,,1/25/2021,Bill,8408,church doors,"Virgil James, Inc",320,NA,6113.02 Capital Improvements:SFX Campus Cap Improvement:SFX Church Improvements,512,36112.16,122137.28
,,,1/27/2021,Bill Payment (Check),2821,3982,Martin Peterson Company Inc.,353,NA,1101.10 Cash:Saints JFX Oper. Acct. #2264:Checking Available,691,-11190,110947.28
,,,1/27/2021,Bill Payment (Check),2721,3974,FP Mailing Solutions,114,NA,1101.10 Cash:Saints JFX Oper. Acct. #2264:Checking Available,691,-95.34,110851.94
,,,1/27/2021,Bill Payment (Check),2823,3984,Ministry Against the Death Penalty,817,NA,1101.10 Cash:Saints JFX Oper. Acct. #2264:Checking Available,691,-250,110601.94
,,,1/27/2021,Bill Payment (Check),2824,3985,OCP,475,NA,1101.10 Cash:Saints JFX Oper. Acct. #2264:Checking Available,691,-283.32,110318.62
,,,1/27/2021,Bill Payment (Check),2825,3986,Pamela Elliot,880,NA,1101.10 Cash:Saints JFX Oper. Acct. #2264:Checking Available,691,-139,110179.62
,,,1/27/2021,Bill Payment (Check),2826,3987,Ron's Artic Snowplowing,304,NA,1101.10 Cash:Saints JFX Oper. Acct. #2264:Checking Available,691,-6341.25,103838.37
,,,1/27/2021,Bill Payment (Check),2827,3988,"Savvas Learning Company, LLC",832,NA,1101.10 Cash:Saints JFX Oper. Acct. #2264:Checking Available,691,-1490.61,102347.76
,,,1/27/2021,Bill Payment (Check),2828,3989,"Schaefer's Wines, Foods & Spirits",56,NA,1101.10 Cash:Saints JFX Oper. Acct. #2264:Checking Available,691,-880.84,101466.92
,,,1/27/2021,Bill Payment (Check),2829,3990,Sparks Interior LTD,877,NA,1101.10 Cash:Saints JFX Oper. Acct. #2264:Checking Available,691,-899,100567.92
,,,1/27/2021,Bill Payment (Check),2830,3991,TelAssist,137,NA,1101.10 Cash:Saints JFX Oper. Acct. #2264:Checking Available,691,-99.34,100468.58
,,,1/27/2021,Bill Payment (Check),2831,3992,The Catholic Bishop of Chicago,230,NA,1101.10 Cash:Saints JFX Oper. Acct. #2264:Checking Available,691,-38.5,100430.08
,,,1/27/2021,Bill Payment (Check),2832,3993,The New York Times,140,NA,1101.10 Cash:Saints JFX Oper. Acct. #2264:Checking Available,691,-108,100322.08
,,,1/27/2021,Bill Payment (Check),2833,3994,Verizon Wireless,118,NA,1101.10 Cash:Saints JFX Oper. Acct. #2264:Checking Available,691,-93.25,100228.83
,,,1/27/2021,Bill Payment (Check),2834,3995,Pitney Bowes SFXS 0015503825,488,NA,1101.10 Cash:Saints JFX Oper. Acct. #2264:Checking Available,691,-111.6,100117.23
,,,1/27/2021,Bill Payment (Check),2835,3996,"Virgil James, Inc",320,NA,1101.22 Cash:Saints JFX Oper. Acct. #2264:Checking Restricted:Building Restricted,587,-36112.16,64005.07
,,,1/27/2021,Bill,8446,955074345,Houghton Mifflin Harcourt,189,NA,"4109 Books & Supplies,Non-Liturgical:Instructional Materials",563,2724.1,66729.17
,,,1/27/2021,Bill,8447,Irish Dance stipend,Claire Labuda,537,NA,4514 Salaries:Special Program Teachers,578,500,67229.17
,,,1/27/2021,Bill,8448,141569/86,Millen Hardware,155,NA,4459 Maintenance & Building Repairs:Janitorial Supplies,118,513.45,67742.62
,,,1/27/2021,Bill,8449,Dec - Jan statement,Bank of America 4433,26,NA,2010.01 Procurement Card Payable:SSJFX,610,7173.94,74916.56
,,,1/27/2021,Bill,8450,Dec - Jan Statement,Bank of America SFX 5830,296,NA,2010.03 Procurement Card Payable:SFXS,611,7884.76,82801.32
,,,1/27/2021,Bill,8451,3104503233,Pitney Bowes SFXS 0015503825,488,NA,4701 Furnishings & Equipment:Admin Furnishings/Equip,132,111.6,82912.92
,,,1/27/2021,Bill,8434,5345499504,AT&T SFX ALL 5570 631,169,NA,-Split-,NA,832.46,83745.38
,,,1/27/2021,Bill,8435,Jan 20 - Feb 19,Comcast SFX Office 2331,142,NA,4434 Other Utilities:Internet/Computer Telecom Costs,66,130.61,83875.99
,,,1/27/2021,Bill,8436,2042347,"Schaefer's Wines, Foods & Spirits",56,NA,4252 Food Service & Meals:Food/Groceries,56,880.84,84756.83
,,,1/27/2021,Bill,8437,1/17 - 2/13,The New York Times,140,NA,4807 Miscellaneous:Dues/Subscriptions,137,108,84864.83
,,,1/27/2021,Bill,8438,RR Covid test,Pamela Elliot,880,NA,6063 Other Extraordinary Expenses:Other Extraordinary Expenses,637,139,85003.83
,,,1/27/2021,Bill,8439,RR camera/elearning,Kit Kalpin,881,NA,4702 Furnishings & Equipment:Instructional Furnishings/Equip,133,22.5,85026.33
,,,1/27/2021,Bill,8440,11321,Impressions In Stone,236,NA,4453 Maintenance & Building Repairs:Ground Supplies,70,177.9,85204.23
,,,1/27/2021,Bill,8441,4026270889,"Savvas Learning Company, LLC",832,NA,"4109 Books & Supplies,Non-Liturgical:Instructional Materials",563,1428.26,86632.49
,,,1/27/2021,Bill,8442,7027402199,"Savvas Learning Company, LLC",832,NA,4807 Miscellaneous:Dues/Subscriptions,137,62.35,86694.84
,,,1/27/2021,Bill,8443,7186942,Anderson Pest Solutions SFX,66,NA,4155 Administrative Expenses:Professional Service Fees,51,79.83,86774.67
,,,1/27/2021,Bill,8444,113790791,Comcast Business (Internet) SFXS 5692,850,NA,4434 Other Utilities:Internet/Computer Telecom Costs,66,224.9,86999.57
,,,1/27/2021,Bill,8445,RR PD,Eileen Kirk,711,NA,4061 Prof. Growth/Minist./Other:Professional Growth,189,195,87194.57
,,,1/27/2021,Bill Payment (Check),2722,3975,"Fun Fluency, Inc",509,NA,1101.10 Cash:Saints JFX Oper. Acct. #2264:Checking Available,691,-6515,80679.57
,,,1/27/2021,Bill Payment (Check),2723,3976,Gospel Weeklies,237,NA,1101.10 Cash:Saints JFX Oper. Acct. #2264:Checking Available,691,-85.22,80594.35
,,,1/27/2021,Bill Payment (Check),2724,3977,Houghton Mifflin Harcourt,189,NA,1101.10 Cash:Saints JFX Oper. Acct. #2264:Checking Available,691,-2724.1,77870.25
,,,1/27/2021,Bill Payment (Check),2725,3978,Impressions In Stone,236,NA,1101.10 Cash:Saints JFX Oper. Acct. #2264:Checking Available,691,-177.9,77692.35
,,,1/27/2021,Bill Payment (Check),2726,3979,Jonathan Metzinger,438,NA,1101.10 Cash:Saints JFX Oper. Acct. #2264:Checking Available,691,-209.99,77482.36
,,,1/27/2021,Bill Payment (Check),2727,3980,Kit Kalpin,881,NA,1101.10 Cash:Saints JFX Oper. Acct. #2264:Checking Available,691,-22.5,77459.86
,,,1/27/2021,Bill Payment (Check),2728,3981,Loyola Press YFF,833,NA,1101.10 Cash:Saints JFX Oper. Acct. #2264:Checking Available,691,-3938.42,73521.44
,,,1/27/2021,Bill Payment (Check),2700,3953,"Active Electrical Supply Co., Inc",107,NA,1101.10 Cash:Saints JFX Oper. Acct. #2264:Checking Available,691,-21.48,73499.96
,,,1/27/2021,Bill Payment (Check),2701,3954,Albertsons/Safeway,156,NA,1101.10 Cash:Saints JFX Oper. Acct. #2264:Checking Available,691,-908.65,72591.31
,,,1/27/2021,Bill Payment (Check),2702,3955,Anderson Lock,185,NA,1101.10 Cash:Saints JFX Oper. Acct. #2264:Checking Available,691,-16.36,72574.95
,,,1/27/2021,Bill Payment (Check),2703,3956,Anderson Pest Solutions SFX,66,NA,1101.10 Cash:Saints JFX Oper. Acct. #2264:Checking Available,691,-79.83,72495.12
,,,1/27/2021,Bill Payment (Check),2704,3957,Anne Hrabe,878,NA,1101.10 Cash:Saints JFX Oper. Acct. #2264:Checking Available,691,-660,71835.12
,,,1/27/2021,Bill Payment (Check),2705,3958,AT&T SFX ALL 5570 631,169,NA,1101.10 Cash:Saints JFX Oper. Acct. #2264:Checking Available,691,-832.46,71002.66
,,,1/27/2021,Bill Payment (Check),2706,3959,AT&T SJC 395,25,NA,1101.10 Cash:Saints JFX Oper. Acct. #2264:Checking Available,691,-188.83,70813.83
,,,1/27/2021,Bill Payment (Check),2707,3960,AT&T SJS,235,NA,1101.10 Cash:Saints JFX Oper. Acct. #2264:Checking Available,691,-334.65,70479.18
,,,1/27/2021,Bill Payment (Check),2708,3961,Bank of America 4433,26,NA,1101.10 Cash:Saints JFX Oper. Acct. #2264:Checking Available,691,-7173.94,63305.24
,,,1/27/2021,Bill Payment (Check),2709,3962,Bank of America SFX 5830,296,NA,1101.10 Cash:Saints JFX Oper. Acct. #2264:Checking Available,691,-7884.76,55420.48
,,,1/27/2021,Bill Payment (Check),2710,3963,Berghaus,270,NA,1101.10 Cash:Saints JFX Oper. Acct. #2264:Checking Available,691,-215.65,55204.83
,,,1/27/2021,Bill Payment (Check),2711,3964,Catholic Bishop of Chicago (BillingSJS),547,NA,1101.10 Cash:Saints JFX Oper. Acct. #2264:Checking Available,691,-13656.38,41548.45
,,,1/27/2021,Bill Payment (Check),2712,3965,Catholic Extension,879,NA,1101.10 Cash:Saints JFX Oper. Acct. #2264:Checking Available,691,-1000,40548.45
,,,1/27/2021,Bill Payment (Check),2713,3966,Church Budget,28,NA,1101.10 Cash:Saints JFX Oper. Acct. #2264:Checking Available,691,-601.18,39947.27
,,,1/27/2021,Bill Payment (Check),2714,3967,Claire Labuda,537,NA,1101.10 Cash:Saints JFX Oper. Acct. #2264:Checking Available,691,-500,39447.27
,,,1/27/2021,Bill Payment (Check),2715,3968,Comcast Business (Internet) SFXS 5692,850,NA,1101.10 Cash:Saints JFX Oper. Acct. #2264:Checking Available,691,-224.9,39222.37
,,,1/27/2021,Bill Payment (Check),2716,3969,Comcast SFX Office 2331,142,NA,1101.10 Cash:Saints JFX Oper. Acct. #2264:Checking Available,691,-130.61,39091.76
,,,1/27/2021,Bill Payment (Check),2717,3970,Crescent Cleaning Company,820,NA,1101.10 Cash:Saints JFX Oper. Acct. #2264:Checking Available,691,-28883.38,10208.38
,,,1/27/2021,Bill Payment (Check),2718,3971,Eileen Kirk,711,NA,1101.10 Cash:Saints JFX Oper. Acct. #2264:Checking Available,691,-195,10013.38
,,,1/27/2021,Bill Payment (Check),2719,3972,Engie SFX,253,NA,1101.10 Cash:Saints JFX Oper. Acct. #2264:Checking Available,691,-8695.25,1318.13
,,,1/27/2021,Bill Payment (Check),2720,3973,Fox Valley Fire and Safety,269,NA,1101.10 Cash:Saints JFX Oper. Acct. #2264:Checking Available,691,-337,981.13
,,,1/27/2021,Bill Payment (Check),2822,3983,Millen Hardware,155,NA,1101.10 Cash:Saints JFX Oper. Acct. #2264:Checking Available,691,-513.45,467.68
,,,1/28/2021,Bill,8581,AF00033510,Catholic Bishop of Chicago (BillingSJS),547,NA,4063 Prof. Growth/Minist./Other:Unemployment Compensation,581,7872,8339.68
,,,1/28/2021,Bill,8565,AF00033555,Catholic Bishop of Chicago (BillingSSJFX),359,NA,4063 Prof. Growth/Minist./Other:Unemployment Compensation,581,679,9018.68
,,,1/29/2021,Bill Payment (Check),2836,3997,AT&T SJC YFF 2253,448,NA,1101.10 Cash:Saints JFX Oper. Acct. #2264:Checking Available,691,-70.93,8947.75
,,,1/29/2021,Bill,7136,Dec - Jan statement,AT&T SJC YFF 2253,448,NA,4400 Telephone,60,70.93,9018.68
,,,1/29/2021,Bill,8555,AF00033699,Catholic Bishop of Chicago (BillingSFXS),548,NA,4155 Administrative Expenses:Professional Service Fees,51,750,9768.68
,,,1/29/2021,Bill,8562,IM00006660,Catholic Bishop of Chicago (BillingSFXS),548,NA,4780 Property/Casualty Insurance,390,19969.33,29738.01
,,,1/29/2021,Bill,8593,FC-0017835,Catholic Bishop of Chicago (BillingSJInt),549,NA,4601 Interest Expense:Interest Expense Oper. Loans,378,322.61,30060.62
,,,1/29/2021,Bill,8582,AF00033721,Catholic Bishop of Chicago (BillingSJS),547,NA,4155 Administrative Expenses:Professional Service Fees,51,750,30810.62
,,,1/29/2021,Bill,8587,IM00006661,Catholic Bishop of Chicago (BillingSJS),547,NA,4780 Property/Casualty Insurance,390,1967.48,32778.1
,,,1/29/2021,Bill,8591,FC-0017962,Catholic Bishop of Chicago (BillingSJInt),549,NA,4601 Interest Expense:Interest Expense Oper. Loans,378,237.91,33016.01
,,,1/29/2021,Bill,8578,IM00006659,Catholic Bishop of Chicago (BillingSSJFX),359,NA,4780 Property/Casualty Insurance,390,12883.52,45899.53
,,,2/1/2021,Vendor Credit,8553,GR00035398,Catholic Bishop of Chicago (BillingSFXS),548,Gratitude Fund,4513 Salaries:Lay Teachers,690,-2045.35,43854.18
,,,2/1/2021,Bill,8588,MR00158205,Catholic Bishop of Chicago (BillingSJS),547,NA,4780 Property/Casualty Insurance,390,4251.45,48105.63
,,,2/1/2021,Bill,8557,IB00181874,Catholic Bishop of Chicago (BillingSFXS),548,NA,4030 Health Insurance-Employer Paid,163,40320,88425.63
,,,2/1/2021,Bill,8558,IB00181875,Catholic Bishop of Chicago (BillingSFXS),548,NA,4030 Health Insurance-Employer Paid,163,2016,90441.63
,,,2/1/2021,Bill,8560,IR00148582,Catholic Bishop of Chicago (BillingSFXS),548,NA,4052 Fringe Benefits:Fringe Benefits - Lay,186,6776,97217.63
,,,2/1/2021,Bill,8563,MR00158177,Catholic Bishop of Chicago (BillingSFXS),548,NA,4780 Property/Casualty Insurance,390,6462.2,103679.83
,,,2/1/2021,Bill,8568,AR00175792,Catholic Bishop of Chicago (BillingSSJFX),359,NA,4751 Archdiocesan Assessment:Archhdiocesean Assesment,253,19754.24,123434.07
,,,2/1/2021,Bill,8569,AR00176048,Catholic Bishop of Chicago (BillingSSJFX),359,NA,"4752 Archdiocesan Assessment:Lease, Lic & Rental Arch Assess",254,463.5,123897.57
,,,2/1/2021,Bill,8570,AR00176289,Catholic Bishop of Chicago (BillingSSJFX),359,NA,4760 PRMAA Assessment,145,6913.98,130811.55
,,,2/1/2021,Bill,8574,IB00182192,Catholic Bishop of Chicago (BillingSSJFX),359,NA,4030 Health Insurance-Employer Paid,163,14112,144923.55
,,,2/1/2021,Bill,8576,IR00148769,Catholic Bishop of Chicago (BillingSSJFX),359,NA,4052 Fringe Benefits:Fringe Benefits - Lay,186,2341,147264.55
,,,2/1/2021,Bill,8579,MR00158359,Catholic Bishop of Chicago (BillingSSJFX),359,NA,4780 Property/Casualty Insurance,390,6292.14,153556.69
,,,2/1/2021,Bill,8583,IB00181907,Catholic Bishop of Chicago (BillingSJS),547,NA,4030 Health Insurance-Employer Paid,163,5040,158596.69
,,,2/1/2021,Bill,8585,IR00148613,Catholic Bishop of Chicago (BillingSJS),547,NA,4052 Fringe Benefits:Fringe Benefits - Lay,186,614,159210.69
,,,2/1/2021,Vendor Credit,8554,GR00035399,Catholic Bishop of Chicago (BillingSFXS),548,Gratitude Fund,4513 Salaries:Lay Teachers,690,-17708.43,141502.26
,,,2/8/2021,Bill,7137,T40002552530,Advanced Disposal SFX Sch,60,NA,4432 Other Utilities:Scavenger Service,64,457.03,141959.29
,,,2/8/2021,Bill,7159,2021-1213,Monk's WIne and Candles SSJFX,65,NA,-Split-,NA,585.65,142544.94
,,,2/8/2021,Bill,7139,26185504,Canon,258,NA,-Split-,NA,1522,144066.94
,,,2/8/2021,Bill,7140,4035261443,Canon Maintanence,563,NA,-Split-,NA,320.16,144387.1
,,,2/8/2021,Bill,7141,3105710,Constellation BG92628,90,NA,4410 Heating Fuel,61,3747.87,148134.97
,,,2/8/2021,Bill,7142,3105714,Constellation BG92634,91,NA,4410 Heating Fuel,61,3105.34,151240.31
,,,2/8/2021,Bill,7143,3099828,Constellation BG142404,128,NA,4410 Heating Fuel,61,216.36,151456.67
,,,2/8/2021,Bill,7144,3099643,Constellation BG91706,130,NA,4410 Heating Fuel,61,189.62,151646.29
,,,2/8/2021,Bill,7145,SM20903-4,Martin Peterson Company Inc.,353,NA,4454 Maintenance & Building Repairs:Building Services,71,1896.5,153542.79
,,,2/8/2021,Bill,7146,SM2092-2,Martin Peterson Company Inc.,353,NA,-Split-,NA,3618,157160.79
,,,2/8/2021,Bill,7147,SW21901,Martin Peterson Company Inc.,353,NA,4455 Maintenance & Building Repairs:Repairs to Buildings,115,2440,159600.79
,,,2/8/2021,Bill,7148,S33417,Martin Peterson Company Inc.,353,NA,4455 Maintenance & Building Repairs:Repairs to Buildings,115,2549.51,162150.3
,,,2/8/2021,Bill,7149,S33719,Martin Peterson Company Inc.,353,NA,4455 Maintenance & Building Repairs:Repairs to Buildings,115,195,162345.3
,,,2/8/2021,Bill,7150,39459,Liguori Publications,585,NA,4657 Altar & Liturgical Supplies:Liturgical Publications,129,55,162400.3
,,,2/8/2021,Bill,7151,1058134,Anderson Lock,185,NA,4451 Maintenance & Building Repairs:Security,68,114,162514.3
,,,2/8/2021,Bill,7152,SFXC 2071,Integrity Systems,553,AMP replacement,4456 Maintenance & Building Repairs:Equipment Services,116,469,162983.3
,,,2/8/2021,Bill,7153,47,Ron's Artic Snowplowing,304,NA,-Split-,NA,8141.25,171124.55
,,,2/8/2021,Bill,7154,597910736,Home Depot Pro SFX,480,NA,-Split-,NA,343.8,171468.35
,,,2/8/2021,Bill,7155,597910728,Home Depot Pro SFX,480,NA,4453 Maintenance & Building Repairs:Ground Supplies,70,343.8,171812.15
,,,2/8/2021,Bill,7156,26185479,Canon SFX,524,NA,4701 Furnishings & Equipment:Admin Furnishings/Equip,132,234,172046.15
,,,2/8/2021,Bill,7157,2021-1212,Monk's WIne and Candles SSJFX,65,NA,-Split-,NA,256.75,172302.9
,,,2/8/2021,Bill,7158,107326,Monk's WIne and Candles SSJFX,65,NA,4653 Altar & Liturgical Supplies:Candles,123,368.2,172671.1
,,,2/8/2021,Bill,7138,T40002552731,Advanced Disposal SJ CH,108,NA,4432 Other Utilities:Scavenger Service,64,429.81,173100.91
,,,2/9/2021,Bill,7182,Chun Jan masses,Jesuit Community of Loyola University,360,3 Jan masses,4012 Salaries:Extra Priests,576,255,173355.91
,,,2/9/2021,Bill,8463,collections,Priests' Health and Retirement,324,NA,6044 Pymt Arch Required Collections:Archdiocesan Priest Retirement,296,2650,176005.91
,,,2/9/2021,Bill,7160,RR tents,Tom Grenke,826,NA,6063 Other Extraordinary Expenses:Other Extraordinary Expenses,637,25.62,176031.53
,,,2/9/2021,Bill,7161,68846,Crescent Cleaning Company,820,NA,-Split-,NA,17629.19,193660.72
,,,2/9/2021,Bill,7162,404269423,Terminix SJS,23,NA,4155 Administrative Expenses:Professional Service Fees,51,73,193733.72
,,,2/9/2021,Bill,7163,404296527,Terminix SJC,179,NA,4155 Administrative Expenses:Professional Service Fees,51,94,193827.72
,,,2/9/2021,Bill,7164,Dec - Jan statement,Nicor SJ Convent,12,NA,4410 Heating Fuel,61,981.85,194809.57
,,,2/9/2021,Bill,7165,147181608,Canon Maintanence,563,NA,4151 Administrative Expenses:Ofc Equipment-Supplies & Maint.,47,204,195013.57
,,,2/9/2021,Bill,7166,JC13311,F.J. Kerrigan Plumbing Co. Inc,87,NA,4455 Maintenance & Building Repairs:Repairs to Buildings,115,3111.04,198124.61
,,,2/9/2021,Bill,7167,JC13317,F.J. Kerrigan Plumbing Co. Inc,87,NA,4455 Maintenance & Building Repairs:Repairs to Buildings,115,4095.86,202220.47
,,,2/9/2021,Bill,7168,Dec statement,"S2Verify, LLC",94,NA,4157 Administrative Expenses:Criminal Background Checks,52,24.52,202244.99
,,,2/9/2021,Bill,7169,Dec 2 statement,"S2Verify, LLC",94,NA,4157 Administrative Expenses:Criminal Background Checks,52,58.26,202303.25
,,,2/9/2021,Bill,7170,March statement,Pitney Bowes Purchase Power SFXCH 6704,806,NA,4153 Administrative Expenses:Postage/Courier Services,49,503.5,202806.75
,,,2/9/2021,Bill,7171,B134985,North American,184,NA,4459 Maintenance & Building Repairs:Janitorial Supplies,118,125.19,202931.94
,,,2/9/2021,Bill,7172,4035253231,Canon Maintanence,563,NA,4151 Administrative Expenses:Ofc Equipment-Supplies & Maint.,47,7.98,202939.92
,,,2/9/2021,Bill,7173,4035253232,Canon Maintanence,563,NA,4151 Administrative Expenses:Ofc Equipment-Supplies & Maint.,47,35.9,202975.82
,,,2/9/2021,Bill,7174,35392206,Johnson Controls Security Solutions SJS,588,NA,4451 Maintenance & Building Repairs:Security,68,519.79,203495.61
,,,2/9/2021,Bill,7175,Jan statement,Comcast SFX Rectory 2307,170,NA,4433 Other Utilities:Cable/Dish Services,65,238.05,203733.66
,,,2/9/2021,Bill,7176,McGrath Jan masses,Canisius House Jesuit Community,450,NA,4012 Salaries:Extra Priests,576,85,203818.66
,,,2/9/2021,Bill,7177,8061011664,Staples SJ,92,NA,-Split-,NA,429.99,204248.65
,,,2/9/2021,Bill,7178,RR Covid expenses,Joseph D'Arco,45,NA,-Split-,NA,1322.73,205571.38
,,,2/9/2021,Bill,7179,B049060,North American,184,NA,4459 Maintenance & Building Repairs:Janitorial Supplies,118,541.02,206112.4
,,,2/9/2021,Bill,7180,RR pkg lot help,Jonathan Metzinger,438,NA,3352 Lease and/or Rental Income:Facility Rental,630,100,206212.4
,,,2/9/2021,Bill,7181,110952101,Accurate Biometrics,24,NA,4157 Administrative Expenses:Criminal Background Checks,52,139.5,206351.9
,,,2/9/2021,Bill,8452,RR key/planner,John Hopkins,101,NA,-Split-,NA,36.44,206388.34
,,,2/9/2021,Bill,8453,MA January 2021,Daniel Mayall,85,NA,4253 Food Service & Meals:Meal Allowance,57,147,206535.34
,,,2/9/2021,Bill,8454,RR h2o and more,Wayne Watts,241,NA,-Split-,NA,591.29,207126.63
,,,2/9/2021,Bill,8455,RR bulletins,Sara Crome,631,NA,4153 Administrative Expenses:Postage/Courier Services,49,9.05,207135.68
,,,2/9/2021,Bill,8456,Lent Mission,IPS Scripture School,362,NA,4802 Miscellaneous:Meetings & Speakers,140,1500,208635.68
,,,2/9/2021,Bill,8457,SJ thru 4/22,Chicago Tribune,222,NA,4807 Miscellaneous:Dues/Subscriptions,137,132,208767.68
,,,2/9/2021,Bill,8458,145525,GO Technology Group Inc.,64,NA,4155 Administrative Expenses:Professional Service Fees,51,1600,210367.68
,,,2/9/2021,Bill,8459,145481,GO Technology Group Inc.,64,NA,4702 Furnishings & Equipment:Instructional Furnishings/Equip,133,184.5,210552.18
,,,2/9/2021,Bill,8460,4035274526,Canon Maintanence,563,NA,4151 Administrative Expenses:Ofc Equipment-Supplies & Maint.,47,331.59,210883.77
,,,2/9/2021,Bill,8461,SM20904-4,Martin Peterson Company Inc.,353,NA,4454 Maintenance & Building Repairs:Building Services,71,4461.5,215345.27
,,,2/9/2021,Bill,8462,reissue 1/8 payroll,Sean McNamara,363,gross$486/Fed$0.33/Med$7.05/SS$30.13/IL$24.06,4517 Salaries:Support Staff - School,673,424.43,215769.7
,,,2/9/2021,Bill,7183,Conf retreat speaker,James Wallace,560,NA,4802 Miscellaneous:Meetings & Speakers,140,300,216069.7
,,,2/10/2021,Bill,8475,642076,Village of Wilmette SFX CH 992100,225,NA,4431 Other Utilities:Water/Sewer,63,357.09,216426.79
,,,2/10/2021,Bill,8476,641465,Village of Wilmette SFX Rectory 201110,226,NA,4431 Other Utilities:Water/Sewer,63,700.05,217126.84
,,,2/10/2021,Bill,8477,641264,Village of Wilmette SFX Conv 190780,227,NA,4431 Other Utilities:Water/Sewer,63,354.02,217480.86
,,,2/10/2021,Bill,8478,feb acct balance,Millen Hardware,155,NA,4459 Maintenance & Building Repairs:Janitorial Supplies,118,363.78,217844.64
,,,2/10/2021,Bill,8479,9540,Wilshore Electric LLC,872,NA,4455 Maintenance & Building Repairs:Repairs to Buildings,115,1740,219584.64
,,,2/10/2021,Bill,8480,7577950,AT&T Messaging SFX CH,71,NA,4400 Telephone,60,14.95,219599.59
,,,2/10/2021,Bill,8464,collections,Catholic Campaign for Human Development,365,NA,6040 Pymt Arch Required Collections:Cath Campaign for Human Develop,180,4665,224264.59
,,,2/10/2021,Bill,8465,collections,Seminarian Collection,592,NA,6032 Pymt Arch Required Collections:Seminaries,178,2935,227199.59
,,,2/10/2021,Bill,8466,collections,Catholic Charities,35,NA,6036 Pymt Arch Required Collections:Catholic Charities,175,1216,228415.59
,,,2/10/2021,Bill,8467,collections,Department of Stewardship and Development,323,NA,6035 Pymt Arch Required Collections:Aid Churches Centl/East Europe,177,1050,229465.59
,,,2/10/2021,Bill,8468,collections,Society of Propagation of Faith,593,NA,6039 Pymt Arch Required Collections:World Mission Sunday,179,1988,231453.59
,,,2/10/2021,Bill,8469,collections,Retirement Fund for Religious,364,NA,6041 Pymt Arch Required Collections:Religious Retirement,181,1863.42,233317.01
,,,2/10/2021,Bill Payment (Check),2861,4023,Johnson Controls Security Solutions SJS,588,NA,1101.10 Cash:Saints JFX Oper. Acct. #2264:Checking Available,691,-519.79,232797.22
,,,2/10/2021,Bill Payment (Check),2862,4024,Jonathan Metzinger,438,NA,1101.10 Cash:Saints JFX Oper. Acct. #2264:Checking Available,691,-100,232697.22
,,,2/10/2021,Bill Payment (Check),2863,4025,Joseph D'Arco,45,NA,1101.10 Cash:Saints JFX Oper. Acct. #2264:Checking Available,691,-1322.73,231374.49
,,,2/10/2021,Bill Payment (Check),2864,4026,Liguori Publications,585,NA,1101.10 Cash:Saints JFX Oper. Acct. #2264:Checking Available,691,-55,231319.49
,,,2/10/2021,Bill Payment (Check),2865,4027,Martin Peterson Company Inc.,353,NA,1101.10 Cash:Saints JFX Oper. Acct. #2264:Checking Available,691,-15160.51,216158.98
,,,2/10/2021,Bill Payment (Check),2866,4028,Monk's WIne and Candles SSJFX,65,NA,1101.10 Cash:Saints JFX Oper. Acct. #2264:Checking Available,691,-1210.6,214948.38
,,,2/10/2021,Bill Payment (Check),2867,4029,Nicor SJ Convent,12,NA,1101.10 Cash:Saints JFX Oper. Acct. #2264:Checking Available,691,-981.85,213966.53
,,,2/10/2021,Bill Payment (Check),2868,4030,North American,184,NA,1101.10 Cash:Saints JFX Oper. Acct. #2264:Checking Available,691,-666.21,213300.32
,,,2/10/2021,Bill Payment (Check),2869,4031,Pitney Bowes Purchase Power SFXCH 6704,806,NA,1101.10 Cash:Saints JFX Oper. Acct. #2264:Checking Available,691,-503.5,212796.82
,,,2/10/2021,Bill Payment (Check),2870,4032,Ron's Artic Snowplowing,304,NA,1101.10 Cash:Saints JFX Oper. Acct. #2264:Checking Available,691,-8141.25,204655.57
,,,2/10/2021,Bill Payment (Check),2871,4033,"S2Verify, LLC",94,NA,1101.10 Cash:Saints JFX Oper. Acct. #2264:Checking Available,691,-82.78,204572.79
,,,2/10/2021,Bill Payment (Check),2872,4034,Sara Crome,631,NA,1101.10 Cash:Saints JFX Oper. Acct. #2264:Checking Available,691,-9.05,204563.74
,,,2/10/2021,Bill Payment (Check),2873,4035,Sean McNamara,363,NA,1101.10 Cash:Saints JFX Oper. Acct. #2264:Checking Available,691,-424.43,204139.31
,,,2/10/2021,Bill Payment (Check),2874,4036,Staples SJ,92,NA,1101.10 Cash:Saints JFX Oper. Acct. #2264:Checking Available,691,-429.99,203709.32
,,,2/10/2021,Bill Payment (Check),2875,4037,Terminix SJC,179,NA,1101.10 Cash:Saints JFX Oper. Acct. #2264:Checking Available,691,-94,203615.32
,,,2/10/2021,Bill Payment (Check),2876,4038,Terminix SJS,23,NA,1101.10 Cash:Saints JFX Oper. Acct. #2264:Checking Available,691,-73,203542.32
,,,2/10/2021,Bill Payment (Check),2877,4039,Tom Grenke,826,NA,1101.10 Cash:Saints JFX Oper. Acct. #2264:Checking Available,691,-25.62,203516.7
,,,2/10/2021,Bill Payment (Check),2878,4040,Wayne Watts,241,NA,1101.10 Cash:Saints JFX Oper. Acct. #2264:Checking Available,691,0,203516.7
,,,2/10/2021,Bill Payment (Check),2879,4046,Catholic Campaign for Human Development,365,NA,101.24J Cash:Saints JFX Oper. Acct. #2264:Checking Restricted:AOC A/P Restricted:CCHD,605,-4665,198851.7
,,,2/10/2021,Bill Payment (Check),2880,4042,Catholic Charities,35,NA,101.24E Cash:Saints JFX Oper. Acct. #2264:Checking Restricted:AOC A/P Restricted:Catholic Charities,652,-1216,197635.7
,,,2/10/2021,Bill Payment (Check),2881,4041,Department of Stewardship and Development,323,NA,101.24C Cash:Saints JFX Oper. Acct. #2264:Checking Restricted:AOC A/P Restricted:Aid Cent. and East. Europe,679,-1050,196585.7
,,,2/10/2021,Bill Payment (Check),2882,4043,Priests' Health and Retirement,324,NA,101.24F Cash:Saints JFX Oper. Acct. #2264:Checking Restricted:AOC A/P Restricted:Retired Priests,603,-2650,193935.7
,,,2/10/2021,Bill Payment (Check),2883,4047,Retirement Fund for Religious,364,NA,101.24K Cash:Saints JFX Oper. Acct. #2264:Checking Restricted:AOC A/P Restricted:Retirement Fund for Religious,680,-1863.42,192072.28
,,,2/10/2021,Bill Payment (Check),2884,4044,Seminarian Collection,592,NA,101.24H Cash:Saints JFX Oper. Acct. #2264:Checking Restricted:AOC A/P Restricted:Seminarian Edu.,604,-2935,189137.28
,,,2/10/2021,Bill Payment (Check),2837,3998,Accurate Biometrics,24,NA,1101.10 Cash:Saints JFX Oper. Acct. #2264:Checking Available,691,-139.5,188997.78
,,,2/10/2021,Bill Payment (Check),2838,3999,Advanced Disposal SFX Sch,60,NA,1101.10 Cash:Saints JFX Oper. Acct. #2264:Checking Available,691,-457.03,188540.75
,,,2/10/2021,Bill Payment (Check),2839,4000,Advanced Disposal SJ CH,108,NA,1101.10 Cash:Saints JFX Oper. Acct. #2264:Checking Available,691,-429.81,188110.94
,,,2/10/2021,Bill Payment (Check),2840,4001,Anderson Lock,185,NA,1101.10 Cash:Saints JFX Oper. Acct. #2264:Checking Available,691,-114,187996.94
,,,2/10/2021,Bill Payment (Check),2841,4002,Canisius House Jesuit Community,450,NA,1101.10 Cash:Saints JFX Oper. Acct. #2264:Checking Available,691,-85,187911.94
,,,2/10/2021,Bill Payment (Check),2842,4003,Canon,258,NA,1101.10 Cash:Saints JFX Oper. Acct. #2264:Checking Available,691,-1522,186389.94
,,,2/10/2021,Bill Payment (Check),2843,4004,Canon Maintanence,563,NA,1101.10 Cash:Saints JFX Oper. Acct. #2264:Checking Available,691,-899.63,185490.31
,,,2/10/2021,Bill Payment (Check),2844,4005,Canon SFX,524,NA,1101.10 Cash:Saints JFX Oper. Acct. #2264:Checking Available,691,-234,185256.31
,,,2/10/2021,Bill Payment (Check),2845,4006,Chicago Tribune,222,NA,1101.10 Cash:Saints JFX Oper. Acct. #2264:Checking Available,691,-132,185124.31
,,,2/10/2021,Bill Payment (Check),2846,4008,Comcast SFX Rectory 2307,170,NA,1101.10 Cash:Saints JFX Oper. Acct. #2264:Checking Available,691,-238.05,184886.26
,,,2/10/2021,Bill Payment (Check),2847,4009,Constellation BG142404,128,NA,1101.10 Cash:Saints JFX Oper. Acct. #2264:Checking Available,691,-216.36,184669.9
,,,2/10/2021,Bill Payment (Check),2848,4010,Constellation BG91706,130,NA,1101.10 Cash:Saints JFX Oper. Acct. #2264:Checking Available,691,-189.62,184480.28
,,,2/10/2021,Bill Payment (Check),2849,4011,Constellation BG92628,90,NA,1101.10 Cash:Saints JFX Oper. Acct. #2264:Checking Available,691,-3747.87,180732.41
,,,2/10/2021,Bill Payment (Check),2850,4012,Constellation BG92634,91,NA,1101.10 Cash:Saints JFX Oper. Acct. #2264:Checking Available,691,-3105.34,177627.07
,,,2/10/2021,Bill Payment (Check),2851,4013,Crescent Cleaning Company,820,NA,1101.10 Cash:Saints JFX Oper. Acct. #2264:Checking Available,691,-17629.19,159997.88
,,,2/10/2021,Bill Payment (Check),2852,4014,Daniel Mayall,85,NA,1101.10 Cash:Saints JFX Oper. Acct. #2264:Checking Available,691,-147,159850.88
,,,2/10/2021,Bill Payment (Check),2853,4015,F.J. Kerrigan Plumbing Co. Inc,87,NA,1101.10 Cash:Saints JFX Oper. Acct. #2264:Checking Available,691,-7206.9,152643.98
,,,2/10/2021,Bill Payment (Check),2854,4016,GO Technology Group Inc.,64,NA,1101.10 Cash:Saints JFX Oper. Acct. #2264:Checking Available,691,-1784.5,150859.48
,,,2/10/2021,Bill Payment (Check),2855,4017,Home Depot Pro SFX,480,NA,1101.10 Cash:Saints JFX Oper. Acct. #2264:Checking Available,691,-687.6,150171.88
,,,2/10/2021,Bill Payment (Check),2856,4018,Integrity Systems,553,NA,1101.10 Cash:Saints JFX Oper. Acct. #2264:Checking Available,691,-469,149702.88
,,,2/10/2021,Bill Payment (Check),2857,4019,IPS Scripture School,362,NA,1101.10 Cash:Saints JFX Oper. Acct. #2264:Checking Available,691,-1500,148202.88
,,,2/10/2021,Bill Payment (Check),2858,4020,James Wallace,560,NA,1101.10 Cash:Saints JFX Oper. Acct. #2264:Checking Available,691,-300,147902.88
,,,2/10/2021,Bill Payment (Check),2885,4045,Society of Propagation of Faith,593,NA,101.24I Cash:Saints JFX Oper. Acct. #2264:Checking Restricted:AOC A/P Restricted:World MIssion Sunday,653,-1988,145914.88
,,,2/10/2021,Bill Payment (Check),2886,4007,Wayne Watts,241,NA,1101.10 Cash:Saints JFX Oper. Acct. #2264:Checking Available,691,0,145914.88
,,,2/10/2021,Bill Payment (Check),2887,4048,Warehouse Direct SJ,82,NA,1101.10 Cash:Saints JFX Oper. Acct. #2264:Checking Available,691,-157.99,145756.89
,,,2/10/2021,Bill Payment (Check),2888,4049,Altorfer Industries Inc,867,NA,1101.10 Cash:Saints JFX Oper. Acct. #2264:Checking Available,691,-11603,134153.89
,,,2/10/2021,Bill Payment (Check),2889,4050,"Kranz, Inc",415,NA,1101.10 Cash:Saints JFX Oper. Acct. #2264:Checking Available,691,-1959.97,132193.92
,,,2/10/2021,Bill Payment (Check),2890,4051,Millen Hardware,155,NA,1101.10 Cash:Saints JFX Oper. Acct. #2264:Checking Available,691,-363.78,131830.14
,,,2/10/2021,Bill Payment (Check),2891,4052,Village of Wilmette SFX CH 992100,225,NA,1101.10 Cash:Saints JFX Oper. Acct. #2264:Checking Available,691,-357.09,131473.05
,,,2/10/2021,Bill Payment (Check),2892,4053,Village of Wilmette SFX Conv 190780,227,NA,1101.10 Cash:Saints JFX Oper. Acct. #2264:Checking Available,691,-354.02,131119.03
,,,2/10/2021,Bill Payment (Check),2893,4054,Village of Wilmette SFX Rectory 201110,226,NA,1101.10 Cash:Saints JFX Oper. Acct. #2264:Checking Available,691,-700.05,130418.98
,,,2/10/2021,Bill Payment (Check),2894,4055,Wilshore Electric LLC,872,NA,1101.10 Cash:Saints JFX Oper. Acct. #2264:Checking Available,691,-1740,128678.98
,,,2/10/2021,Bill Payment (Check),2895,4056,AT&T Messaging SFX CH,71,NA,1101.10 Cash:Saints JFX Oper. Acct. #2264:Checking Available,691,-14.95,128664.03
,,,2/10/2021,Bill Payment (Check),2859,4021,Jesuit Community of Loyola University,360,NA,1101.10 Cash:Saints JFX Oper. Acct. #2264:Checking Available,691,-255,128409.03
,,,2/10/2021,Bill Payment (Check),2860,4022,John Hopkins,101,NA,1101.10 Cash:Saints JFX Oper. Acct. #2264:Checking Available,691,-36.44,128372.59
,,,2/10/2021,Bill,8470,4846960-0,Warehouse Direct SJ,82,NA,4459 Maintenance & Building Repairs:Janitorial Supplies,118,157.99,128530.58
,,,2/10/2021,Bill,8471,C2440401,Altorfer Industries Inc,867,NA,6063 Other Extraordinary Expenses:Other Extraordinary Expenses,637,3410,131940.58
,,,2/10/2021,Bill,8472,1742892-00,"Kranz, Inc",415,NA,4459 Maintenance & Building Repairs:Janitorial Supplies,118,1509.53,133450.11
,,,2/10/2021,Bill,8473,1738171-04,"Kranz, Inc",415,NA,4459 Maintenance & Building Repairs:Janitorial Supplies,118,450.44,133900.55
,,,2/10/2021,Bill,8474,C2429302,Altorfer Industries Inc,867,NA,6063 Other Extraordinary Expenses:Other Extraordinary Expenses,637,8193,142093.55
,,,2/11/2021,Bill Payment (Check),2896,4057,Wayne Watts,241,NA,1101.10 Cash:Saints JFX Oper. Acct. #2264:Checking Available,691,-591.29,141502.26
,,,2/11/2021,Bill Payment (Check),2897,4058,Comcast Business (Internet) SJS 5239,851,NA,1101.10 Cash:Saints JFX Oper. Acct. #2264:Checking Available,691,-293.35,141208.91
,,,2/11/2021,Bill Payment (Check),2898,4059,Johnson Controls Security Solutions SJC,589,NA,1101.10 Cash:Saints JFX Oper. Acct. #2264:Checking Available,691,-892.69,140316.22
,,,2/11/2021,Bill Payment (Check),2899,4060,Johnson Controls Security Solutions SJS,588,NA,1101.10 Cash:Saints JFX Oper. Acct. #2264:Checking Available,691,-892.69,139423.53
,,,2/11/2021,Bill,8484,35476951,Johnson Controls Security Solutions SJS,588,NA,4451 Maintenance & Building Repairs:Security,68,892.69,140316.22
,,,2/11/2021,Bill,8481,115620077,Comcast Business (Internet) SJS 5239,851,NA,4434 Other Utilities:Internet/Computer Telecom Costs,66,293.35,140609.57
,,,2/11/2021,Bill,8482,35476952,Johnson Controls SJconvent 2639AD,460,NA,4451 Maintenance & Building Repairs:Security,68,215.91,140825.48
,,,2/11/2021,Bill,8483,35476959,Johnson Controls Security Solutions SJC,589,NA,4451 Maintenance & Building Repairs:Security,68,892.69,141718.17
,,,2/11/2021,Bill Payment (Check),2900,4061,Johnson Controls SJconvent 2639AD,460,NA,1101.10 Cash:Saints JFX Oper. Acct. #2264:Checking Available,691,-215.91,141502.26
,,,2/17/2021,Bill,8566,AF00033858,Catholic Bishop of Chicago (BillingSSJFX),359,NA,4803 Miscellaneous:Ministry Formation & Education,142,466.66,141968.92
,,,2/17/2021,Bill,8567,AF00033873,Catholic Bishop of Chicago (BillingSSJFX),359,NA,4803 Miscellaneous:Ministry Formation & Education,142,466.66,142435.58
,,,2/22/2021,Bill,8509,0308012-IN,Benedictine Sisters Altar Bread,61,NA,4651 Altar & Liturgical Supplies:Hosts and Wine,121,292.08,142727.66
,,,2/22/2021,Bill,8508,annual dues,New Trier Multi-Faith Alliance,368,NA,4807 Miscellaneous:Dues/Subscriptions,137,200,142927.66
,,,2/22/2021,Bill,8511,RR PD,Collin McShane,568,NA,4061 Prof. Growth/Minist./Other:Professional Growth,189,249.99,143177.65
,,,2/22/2021,Bill,8512,RR Winter book club,Nicole Collins,272,NA,"4109 Books & Supplies,Non-Liturgical:Instructional Materials",563,97.98,143275.63
,,,2/22/2021,Bill,8513,paycheck 4 days sub,Bridget Clancy,369,"Gross$440,Fed$4.40,SS$27.28,Med$6.38",4516 Salaries:Substitute Teachers,579,401.94,143677.57
,,,2/22/2021,Bill,8514,110952011,Accurate Biometrics,24,NA,4157 Administrative Expenses:Criminal Background Checks,52,279,143956.57
,,,2/22/2021,Bill,8515,10573050-01,"Active Electrical Supply Co., Inc",107,NA,4459 Maintenance & Building Repairs:Janitorial Supplies,118,24.27,143980.84
,,,2/22/2021,Bill,8516,404611312,Terminix SJC,179,NA,4155 Administrative Expenses:Professional Service Fees,51,94,144074.84
,,,2/22/2021,Bill,8517,404612529,Terminix SJS,23,NA,4155 Administrative Expenses:Professional Service Fees,51,73,144147.84
,,,2/22/2021,Bill,8518,68990,Crescent Cleaning Company,820,NA,6063 Other Extraordinary Expenses:Other Extraordinary Expenses,637,219.98,144367.82
,,,2/22/2021,Bill,8519,69164,Crescent Cleaning Company,820,NA,6063 Other Extraordinary Expenses:Other Extraordinary Expenses,637,219.98,144587.8
,,,2/22/2021,Bill,8485,3105662,Constellation BG91705,129,NA,4410 Heating Fuel,61,850.11,145437.91
,,,2/22/2021,Bill,8486,3105663,Constellation BG91706,130,NA,4410 Heating Fuel,61,1238.86,146676.77
,,,2/22/2021,Bill,8487,3105847,Constellation BG142404,128,NA,4410 Heating Fuel,61,1284.43,147961.2
,,,2/22/2021,Bill,8488,RR registration,Hillary Richards,741,NA,"4109 Books & Supplies,Non-Liturgical:Instructional Materials",563,274,148235.2
,,,2/22/2021,Bill,8489,115620007,Comcast Business (Internet) SFXS 5692,850,NA,-Split-,NA,449.8,148685
,,,2/22/2021,Bill,8490,RR prof dev,Mary Kate Georgalas,47,NA,4061 Prof. Growth/Minist./Other:Professional Growth,189,10,148695
,,,2/22/2021,Bill,8491,backround checks,"S2Verify, LLC",94,NA,4157 Administrative Expenses:Criminal Background Checks,52,103.36,148798.36
,,,2/22/2021,Bill,8492,February statement,Comcast Business (TV) SFXS 1576,57,NA,4433 Other Utilities:Cable/Dish Services,65,42.56,148840.92
,,,2/22/2021,Bill,8493,3104370,Constellation BG91704,127,NA,4410 Heating Fuel,61,1363.09,150204.01
,,,2/22/2021,Bill,8494,642075,Village of Wilmette SFX SCH 992090,228,NA,4431 Other Utilities:Water/Sewer,63,175.61,150379.62
,,,2/22/2021,Bill,8495,641466,Village of Wilmette SFX SCH 201120,476,NA,4431 Other Utilities:Water/Sewer,63,478.98,150858.6
,,,2/22/2021,Bill,8496,7027411209,"Savvas Learning Company, LLC",832,NA,"4109 Books & Supplies,Non-Liturgical:Instructional Materials",563,49.88,150908.48
,,,2/22/2021,Bill,8556,AF00033940,Catholic Bishop of Chicago (BillingSFXS),548,NA,3117 Fees:Graduation Fee,33,297,151205.48
,,,2/22/2021,Bill,8520,Feb 11 tuning,"Robert Portle, M.M.",718,NA,4155 Administrative Expenses:Professional Service Fees,51,88,151293.48
,,,2/22/2021,Bill,8521,Lenten retreat speak,Soul Play,370,NA,4802 Miscellaneous:Meetings & Speakers,140,350,151643.48
,,,2/22/2021,Bill,8522,RR PD,Caroline Head,706,NA,4061 Prof. Growth/Minist./Other:Professional Growth,189,99,151742.48
,,,2/22/2021,Bill,8523,1.51979E+11,Office Depot Business Credit,139,NA,6063 Other Extraordinary Expenses:Other Extraordinary Expenses,637,99.9,151842.38
,,,2/22/2021,Bill,8524,mult invoices,Garvey's Office Products,134,NA,"4109 Books & Supplies,Non-Liturgical:Instructional Materials",563,579.79,152422.17
,,,2/22/2021,Bill,8525,807,Meco Electric Company Inc.,147,NA,6063 Other Extraordinary Expenses:Other Extraordinary Expenses,637,3338,155760.17
,,,2/22/2021,Bill,8526,13804,Meco Electric Company Inc.,147,NA,6063 Other Extraordinary Expenses:Other Extraordinary Expenses,637,2995,158755.17
,,,2/22/2021,Bill,8527,13803,Meco Electric Company Inc.,147,NA,6063 Other Extraordinary Expenses:Other Extraordinary Expenses,637,1284.5,160039.67
,,,2/22/2021,Bill,8528,13805,Meco Electric Company Inc.,147,NA,4454 Maintenance & Building Repairs:Building Services,71,531,160570.67
,,,2/22/2021,Bill,8529,13806,Meco Electric Company Inc.,147,NA,4820 Miscellaneous:Other Miscellaneous Expense,311,3182,163752.67
,,,2/22/2021,Bill,8497,7385144,Anderson Pest Solutions SFX,66,NA,4155 Administrative Expenses:Professional Service Fees,51,79.83,163832.5
,,,2/22/2021,Bill,8498,3105661,Constellation BG91704,127,NA,4410 Heating Fuel,61,1533.69,165366.19
,,,2/22/2021,Bill,8499,28525,Bye-Mor Inc.,284,NA,4154 Administrative Expenses:Office Supplies,50,132,165498.19
,,,2/22/2021,Bill,8500,SFX1042021,Worthington Direct,382,NA,4702 Furnishings & Equipment:Instructional Furnishings/Equip,133,1264.58,166762.77
,,,2/22/2021,Bill,8501,RR Books,Linda Sawyer,243,NA,"4107 Books & Supplies,Non-Liturgical:Library Materials",562,16.48,166779.25
,,,2/22/2021,Bill,8502,PINV2030285,Garvey's Office Products,134,NA,"4109 Books & Supplies,Non-Liturgical:Instructional Materials",563,67.92,166847.17
,,,2/22/2021,Bill,8503,PINV2029595,Garvey's Office Products,134,NA,4154 Administrative Expenses:Office Supplies,50,6.14,166853.31
,,,2/22/2021,Bill,8504,PINV2028689,Garvey's Office Products,134,NA,4154 Administrative Expenses:Office Supplies,50,118.3,166971.61
,,,2/22/2021,Bill,8505,PINV2029174,Garvey's Office Products,134,NA,4151 Administrative Expenses:Ofc Equipment-Supplies & Maint.,47,15.78,166987.39
,,,2/22/2021,Bill,8506,PINV2028178,Garvey's Office Products,134,NA,4154 Administrative Expenses:Office Supplies,50,139.6,167126.99
,,,2/22/2021,Bill,8507,12/29 - 2/9,Nicor SFX Sch,168,NA,4410 Heating Fuel,61,220.67,167347.66
,,,2/22/2021,Bill,8510,S396700,1XL Learning,582,NA,"4110 Books & Supplies,Non-Liturgical:Instructional Software",187,6317,173664.66
,,,2/23/2021,Bill,8537,2021-STFX-6,"Fun Fluency, Inc",509,NA,-Split-,NA,6515,180179.66
,,,2/23/2021,Bill,8538,5834,Shephard Plumbing,154,NA,4455 Maintenance & Building Repairs:Repairs to Buildings,115,366,180545.66
,,,2/23/2021,Bill,8539,Feb statement,Albertsons/Safeway,156,NA,4252 Food Service & Meals:Food/Groceries,56,556.05,181101.71
,,,2/23/2021,Bill,8540,Action Mass 2/28,Leo Agustina,373,NA,4012 Salaries:Extra Priests,576,100,181201.71
,,,2/23/2021,Vendor Credit,8541,1743151-00,"Kranz, Inc",415,NA,4459 Maintenance & Building Repairs:Janitorial Supplies,118,-456.28,180745.43
,,,2/23/2021,Bill,8542,RR repair,Joseph D'Arco,45,NA,4456 Maintenance & Building Repairs:Equipment Services,116,246,180991.43
,,,2/23/2021,Bill,8543,RR ty gifts,Sarah Doran,700,NA,4806 Miscellaneous:Gifts & Donations,139,300,181291.43
,,,2/23/2021,Bill,8544,549615,Junior Library Guild,245,NA,"4107 Books & Supplies,Non-Liturgical:Library Materials",562,245.05,181536.48
,,,2/23/2021,Bill Payment (Check),2944,4106,Terminix SJC,179,NA,1101.10 Cash:Saints JFX Oper. Acct. #2264:Checking Available,691,-94,181442.48
,,,2/23/2021,Bill Payment (Check),2945,4107,Terminix SJS,23,NA,1101.10 Cash:Saints JFX Oper. Acct. #2264:Checking Available,691,-73,181369.48
,,,2/23/2021,Bill Payment (Check),2946,4108,Village of Wilmette SFX SCH 201120,476,NA,1101.10 Cash:Saints JFX Oper. Acct. #2264:Checking Available,691,-478.98,180890.5
,,,2/23/2021,Bill Payment (Check),2947,4109,Village of Wilmette SFX SCH 992090,228,NA,1101.10 Cash:Saints JFX Oper. Acct. #2264:Checking Available,691,-175.61,180714.89
,,,2/23/2021,Bill Payment (Check),2948,4110,Worthington Direct,382,NA,1101.10 Cash:Saints JFX Oper. Acct. #2264:Checking Available,691,-1264.58,179450.31
,,,2/23/2021,Bill Payment (Check),2949,4111,"Bruno Construction Masonry, Inc",372,NA,1101.22 Cash:Saints JFX Oper. Acct. #2264:Checking Restricted:Building Restricted,587,0,179450.31
,,,2/23/2021,Bill Payment (Check),2950,4112,"Holton Brothers, Inc",643,NA,1101.22 Cash:Saints JFX Oper. Acct. #2264:Checking Restricted:Building Restricted,587,-15860,163590.31
,,,2/23/2021,Bill Payment (Check),2951,4113,"Tile Decor, Inc",371,NA,1101.22 Cash:Saints JFX Oper. Acct. #2264:Checking Restricted:Building Restricted,587,0,163590.31
,,,2/23/2021,Bill Payment (Check),2911,4072,Bye-Mor Inc.,284,NA,1101.10 Cash:Saints JFX Oper. Acct. #2264:Checking Available,691,-132,163458.31
,,,2/23/2021,Bill Payment (Check),2912,4073,Caroline Head,706,NA,1101.10 Cash:Saints JFX Oper. Acct. #2264:Checking Available,691,-99,163359.31
,,,2/23/2021,Bill Payment (Check),2913,4074,Collin McShane,568,NA,1101.10 Cash:Saints JFX Oper. Acct. #2264:Checking Available,691,-249.99,163109.32
,,,2/23/2021,Bill Payment (Check),2914,4075,Comcast Business (Internet) SFXS 5692,850,NA,1101.10 Cash:Saints JFX Oper. Acct. #2264:Checking Available,691,-449.8,162659.52
,,,2/23/2021,Bill Payment (Check),2915,4076,Comcast Business (TV) SFXS 1576,57,NA,1101.10 Cash:Saints JFX Oper. Acct. #2264:Checking Available,691,-42.56,162616.96
,,,2/23/2021,Bill Payment (Check),2916,4077,Constellation BG142404,128,NA,1101.10 Cash:Saints JFX Oper. Acct. #2264:Checking Available,691,-1284.43,161332.53
,,,2/23/2021,Bill Payment (Check),2917,4078,Constellation BG91704,127,NA,1101.10 Cash:Saints JFX Oper. Acct. #2264:Checking Available,691,-2896.78,158435.75
,,,2/23/2021,Bill Payment (Check),2918,4079,Constellation BG91705,129,NA,1101.10 Cash:Saints JFX Oper. Acct. #2264:Checking Available,691,-850.11,157585.64
,,,2/23/2021,Bill Payment (Check),2919,4080,Constellation BG91706,130,NA,1101.10 Cash:Saints JFX Oper. Acct. #2264:Checking Available,691,-1238.86,156346.78
,,,2/23/2021,Bill Payment (Check),2920,4081,Crescent Cleaning Company,820,NA,1101.10 Cash:Saints JFX Oper. Acct. #2264:Checking Available,691,-439.96,155906.82
,,,2/23/2021,Bill Payment (Check),2921,4082,"Fun Fluency, Inc",509,NA,1101.10 Cash:Saints JFX Oper. Acct. #2264:Checking Available,691,-6515,149391.82
,,,2/23/2021,Bill Payment (Check),2922,4083,Garvey's Office Products,134,NA,1101.10 Cash:Saints JFX Oper. Acct. #2264:Checking Available,691,-927.53,148464.29
,,,2/23/2021,Bill Payment (Check),2923,4084,"Grage Management, LLC",487,NA,1101.10 Cash:Saints JFX Oper. Acct. #2264:Checking Available,691,-412.5,148051.79
,,,2/23/2021,Bill Payment (Check),2924,4085,Hillary Richards,741,NA,1101.10 Cash:Saints JFX Oper. Acct. #2264:Checking Available,691,-274,147777.79
,,,2/23/2021,Bill Payment (Check),2925,4086,John Hopkins,101,NA,1101.10 Cash:Saints JFX Oper. Acct. #2264:Checking Available,691,-68.83,147708.96
,,,2/23/2021,Bill Payment (Check),2926,4087,Joseph D'Arco,45,NA,1101.10 Cash:Saints JFX Oper. Acct. #2264:Checking Available,691,-246,147462.96
,,,2/23/2021,Bill Payment (Check),2927,4089,Junior Library Guild,245,NA,1101.10 Cash:Saints JFX Oper. Acct. #2264:Checking Available,691,-408.6,147054.36
,,,2/23/2021,Bill Payment (Check),2928,4090,Leo Agustina,373,NA,1101.10 Cash:Saints JFX Oper. Acct. #2264:Checking Available,691,-100,146954.36
,,,2/23/2021,Bill Payment (Check),2929,4091,Linda Sawyer,243,NA,1101.10 Cash:Saints JFX Oper. Acct. #2264:Checking Available,691,-16.48,146937.88
,,,2/23/2021,Bill Payment (Check),2930,4092,Mary Kate Georgalas,47,NA,1101.10 Cash:Saints JFX Oper. Acct. #2264:Checking Available,691,-10,146927.88
,,,2/23/2021,Bill Payment (Check),2931,4093,Meco Electric Company Inc.,147,NA,1101.10 Cash:Saints JFX Oper. Acct. #2264:Checking Available,691,-12814.5,134113.38
,,,2/23/2021,Bill Payment (Check),2932,4094,New Trier Multi-Faith Alliance,368,NA,1101.10 Cash:Saints JFX Oper. Acct. #2264:Checking Available,691,-200,133913.38
,,,2/23/2021,Bill Payment (Check),2933,4095,Nicole Collins,272,NA,1101.10 Cash:Saints JFX Oper. Acct. #2264:Checking Available,691,-97.98,133815.4
,,,2/23/2021,Bill Payment (Check),2934,4096,Nicor SFX Sch,168,NA,1101.10 Cash:Saints JFX Oper. Acct. #2264:Checking Available,691,-220.67,133594.73
,,,2/23/2021,Bill Payment (Check),2935,4097,Office Depot Business Credit,139,NA,1101.10 Cash:Saints JFX Oper. Acct. #2264:Checking Available,691,-99.9,133494.83
,,,2/23/2021,Bill Payment (Check),2936,4098,Rich Jakubik,374,NA,1101.10 Cash:Saints JFX Oper. Acct. #2264:Checking Available,691,-75,133419.83
,,,2/23/2021,Bill Payment (Check),2901,4062,1XL Learning,582,NA,1101.10 Cash:Saints JFX Oper. Acct. #2264:Checking Available,691,-6317,127102.83
,,,2/23/2021,Bill Payment (Check),2902,4063,Accurate Biometrics,24,NA,1101.10 Cash:Saints JFX Oper. Acct. #2264:Checking Available,691,-279,126823.83
,,,2/23/2021,Bill Payment (Check),2903,4064,"Active Electrical Supply Co., Inc",107,NA,1101.10 Cash:Saints JFX Oper. Acct. #2264:Checking Available,691,-24.27,126799.56
,,,2/23/2021,Bill Payment (Check),2904,4065,Albertsons/Safeway,156,NA,1101.10 Cash:Saints JFX Oper. Acct. #2264:Checking Available,691,-556.05,126243.51
,,,2/23/2021,Bill Payment (Check),2905,4066,Anderson Pest Solutions SFX,66,NA,1101.10 Cash:Saints JFX Oper. Acct. #2264:Checking Available,691,-79.83,126163.68
,,,2/23/2021,Bill Payment (Check),2906,4067,AT&T SFX ALL 5570 631,169,NA,1101.10 Cash:Saints JFX Oper. Acct. #2264:Checking Available,691,-825.06,125338.62
,,,2/23/2021,Bill Payment (Check),2907,4068,AT&T SJC 395,25,NA,1101.10 Cash:Saints JFX Oper. Acct. #2264:Checking Available,691,-5.42,125333.2
,,,2/23/2021,Bill Payment (Check),2908,4069,AT&T SJS,235,NA,1101.10 Cash:Saints JFX Oper. Acct. #2264:Checking Available,691,-9.97,125323.23
,,,2/23/2021,Bill Payment (Check),2909,4070,Benedictine Sisters Altar Bread,61,NA,1101.10 Cash:Saints JFX Oper. Acct. #2264:Checking Available,691,-292.08,125031.15
,,,2/23/2021,Bill Payment (Check),2910,4071,Bridget Clancy,369,NA,1101.10 Cash:Saints JFX Oper. Acct. #2264:Checking Available,691,-401.94,124629.21
,,,2/23/2021,Bill Payment (Check),2937,4099,"Robert Portle, M.M.",718,NA,1101.10 Cash:Saints JFX Oper. Acct. #2264:Checking Available,691,-88,124541.21
,,,2/23/2021,Bill Payment (Check),2938,4100,"S2Verify, LLC",94,NA,1101.10 Cash:Saints JFX Oper. Acct. #2264:Checking Available,691,-103.36,124437.85
,,,2/23/2021,Bill Payment (Check),2939,4101,Sarah Doran,700,NA,1101.10 Cash:Saints JFX Oper. Acct. #2264:Checking Available,691,-300,124137.85
,,,2/23/2021,Bill Payment (Check),2940,4102,"Savvas Learning Company, LLC",832,NA,1101.10 Cash:Saints JFX Oper. Acct. #2264:Checking Available,691,-49.88,124087.97
,,,2/23/2021,Bill Payment (Check),2941,4103,Shephard Plumbing,154,NA,1101.10 Cash:Saints JFX Oper. Acct. #2264:Checking Available,691,-366,123721.97
,,,2/23/2021,Bill Payment (Check),2942,4104,Soul Play,370,NA,1101.10 Cash:Saints JFX Oper. Acct. #2264:Checking Available,691,-350,123371.97
,,,2/23/2021,Bill Payment (Check),2943,4105,TelAssist,137,NA,1101.10 Cash:Saints JFX Oper. Acct. #2264:Checking Available,691,-100.32,123271.65
,,,2/23/2021,Bill,8545,549718,Junior Library Guild,245,NA,"4107 Books & Supplies,Non-Liturgical:Library Materials",562,163.55,123435.2
,,,2/23/2021,Bill,8546,5989801602,AT&T SFX ALL 5570 631,169,NA,-Split-,NA,825.06,124260.26
,,,2/23/2021,Bill,8547,RR gc and music,John Hopkins,101,NA,-Split-,NA,68.83,124329.09
,,,2/23/2021,Bill,8548,help w 1st Recon,Rich Jakubik,374,NA,4012 Salaries:Extra Priests,576,75,124404.09
,,,2/23/2021,Bill,8549,19-988-331,TelAssist,137,NA,4434 Other Utilities:Internet/Computer Telecom Costs,66,100.32,124504.41
,,,2/23/2021,Bill,8550,5972901609,AT&T SJC 395,25,NA,4400 Telephone,60,5.42,124509.83
,,,2/23/2021,Bill,8530,13808,Meco Electric Company Inc.,147,NA,6063 Other Extraordinary Expenses:Other Extraordinary Expenses,637,1484,125993.83
,,,2/23/2021,Bill,8531,10359,"Holton Brothers, Inc",643,NA,6112.08 Capital Improvements:St Joseph Campus Cap Improvemnt:Church Masonry,629,9270,135263.83
,,,2/23/2021,Bill,8532,10367,"Holton Brothers, Inc",643,NA,6113.05 Capital Improvements:SFX Campus Cap Improvement:Church Masonry,557,6590,141853.83
,,,2/23/2021,Bill,8533,Marble,"Tile Decor, Inc",371,NA,6113.02 Capital Improvements:SFX Campus Cap Improvement:SFX Church Improvements,512,1070,142923.83
,,,2/23/2021,Bill,8534,caulking,"Bruno Construction Masonry, Inc",372,NA,6113.02 Capital Improvements:SFX Campus Cap Improvement:SFX Church Improvements,512,2600,145523.83
,,,2/23/2021,Bill,8535,5994801605,AT&T SJS,235,NA,4400 Telephone,60,9.97,145533.8
,,,2/23/2021,Bill,8536,1014,"Grage Management, LLC",487,NA,-Split-,NA,412.5,145946.3
,,,2/24/2021,Bill Payment (Check),2953,4115,"Tile Decor, Inc",371,NA,1101.22 Cash:Saints JFX Oper. Acct. #2264:Checking Restricted:Building Restricted,587,-1070,144876.3
,,,2/24/2021,Bill Payment (Check),2952,4114,"Bruno Construction Masonry, Inc",372,NA,1101.22 Cash:Saints JFX Oper. Acct. #2264:Checking Restricted:Building Restricted,587,-2600,142276.3
,,,2/25/2021,Bill,8551,1401808,Cecil Painting,164,NA,4455 Maintenance & Building Repairs:Repairs to Buildings,115,3600,145876.3
,,,2/25/2021,Bill Payment (Check),2954,4088,Cecil Painting,164,NA,1101.10 Cash:Saints JFX Oper. Acct. #2264:Checking Available,691,-3600,142276.3
,,,2/26/2021,Bill,8594,FC-0018067,Catholic Bishop of Chicago (BillingSJInt),549,NA,4601 Interest Expense:Interest Expense Oper. Loans,378,311.49,142587.79
,,,2/26/2021,Bill,8592,FC-0018193,Catholic Bishop of Chicago (BillingSJInt),549,NA,4601 Interest Expense:Interest Expense Oper. Loans,378,229.71,142817.5
,,,3/1/2021,Bill,8575,IB00182785,Catholic Bishop of Chicago (BillingSSJFX),359,NA,4030 Health Insurance-Employer Paid,163,14112,156929.5
,,,3/1/2021,Bill,8573,AR00177098,Catholic Bishop of Chicago (BillingSSJFX),359,NA,4760 PRMAA Assessment,145,6913.98,163843.48
,,,3/1/2021,Bill,8572,AR00176857,Catholic Bishop of Chicago (BillingSSJFX),359,NA,"4752 Archdiocesan Assessment:Lease, Lic & Rental Arch Assess",254,463.5,164306.98
,,,3/1/2021,Bill,8571,AR00176601,Catholic Bishop of Chicago (BillingSSJFX),359,NA,4751 Archdiocesan Assessment:Archhdiocesean Assesment,253,19754.24,184061.22
,,,3/1/2021,Bill,8564,MR00158636,Catholic Bishop of Chicago (BillingSFXS),548,NA,4780 Property/Casualty Insurance,390,6462.2,190523.42
,,,3/1/2021,Bill,8561,IR00149034,Catholic Bishop of Chicago (BillingSFXS),548,NA,4052 Fringe Benefits:Fringe Benefits - Lay,186,6879,197402.42
,,,3/1/2021,Bill,8577,IR00149220,Catholic Bishop of Chicago (BillingSSJFX),359,NA,4052 Fringe Benefits:Fringe Benefits - Lay,186,2341,199743.42
,,,3/1/2021,Bill,8559,IB00182471,Catholic Bishop of Chicago (BillingSFXS),548,NA,4030 Health Insurance-Employer Paid,163,40320,240063.42
,,,3/1/2021,Bill,8580,MR00158818,Catholic Bishop of Chicago (BillingSSJFX),359,NA,4780 Property/Casualty Insurance,390,6292.14,246355.56
,,,3/1/2021,Bill,8589,MR00158664,Catholic Bishop of Chicago (BillingSJS),547,NA,4780 Property/Casualty Insurance,390,4251.45,250607.01
,,,3/1/2021,Bill,8586,IR00149065,Catholic Bishop of Chicago (BillingSJS),547,NA,4052 Fringe Benefits:Fringe Benefits - Lay,186,614,251221.01
,,,3/1/2021,Bill,8584,IB00182503,Catholic Bishop of Chicago (BillingSJS),547,NA,4030 Health Insurance-Employer Paid,163,5040,256261.01
,,,3/2/2021,Bill Payment (Check),2955,4116,Cecil Painting,164,NA,1101.10 Cash:Saints JFX Oper. Acct. #2264:Checking Available,691,-600,255661.01
,,,3/2/2021,Bill,8552,1401811,Cecil Painting,164,NA,4455 Maintenance & Building Repairs:Repairs to Buildings,115,600,256261.01
,,,3/8/2021,Bill,8619,MA Feb 2021,Daniel Mayall,85,NA,4253 Food Service & Meals:Meal Allowance,57,63,256324.01
,,,3/8/2021,Bill,8620,1060078,Anderson Lock,185,NA,4451 Maintenance & Building Repairs:Security,68,114,256438.01
,,,3/8/2021,Bill,8621,RI104799347,FP Mailing Solutions SJS,381,NA,4701 Furnishings & Equipment:Admin Furnishings/Equip,132,133.06,256571.07
,,,3/8/2021,Bill,8622,C2440402,Altorfer Industries Inc,867,NA,6063 Other Extraordinary Expenses:Other Extraordinary Expenses,637,3267,259838.07
,,,3/8/2021,Bill,8623,C2429303,Altorfer Industries Inc,867,NA,6063 Other Extraordinary Expenses:Other Extraordinary Expenses,637,9529,269367.07
,,,3/8/2021,Bill,8624,2/14-3/13,The New York Times,140,NA,4807 Miscellaneous:Dues/Subscriptions,137,6,269373.07
,,,3/8/2021,Bill,8625,3122391,Constellation BG142404,128,NA,4410 Heating Fuel,61,679.64,270052.71
,,,3/8/2021,Bill,8626,3122205,Constellation BG91705,129,NA,4410 Heating Fuel,61,666.99,270719.7
,,,3/8/2021,Bill,8627,3122206,Constellation BG91706,130,NA,4410 Heating Fuel,61,777.46,271497.16
,,,3/8/2021,Bill,8628,March,Comcast SFX Rectory 2307,170,NA,4433 Other Utilities:Cable/Dish Services,65,238.01,271735.17
,,,3/8/2021,Bill,8629,9641781,Illinois Office of the State Fire Marshal,508,NA,4456 Maintenance & Building Repairs:Equipment Services,116,95,271830.17
,,,3/8/2021,Bill,8630,26344154,Canon SFX,524,NA,4701 Furnishings & Equipment:Admin Furnishings/Equip,132,234,272064.17
,,,3/8/2021,Bill,8631,5879,Shephard Plumbing,154,NA,4455 Maintenance & Building Repairs:Repairs to Buildings,115,475,272539.17
,,,3/8/2021,Bill,8595,RR PD,Annie Buxton,623,NA,4061 Prof. Growth/Minist./Other:Professional Growth,189,225,272764.17
,,,3/8/2021,Bill,8596,RR Supplies/Snacks,Jennifer Miller,262,NA,-Split-,NA,53,272817.17
,,,3/8/2021,Bill,8597,RR background check,Amy Butterworth,119,NA,4157 Administrative Expenses:Criminal Background Checks,52,20,272837.17
,,,3/8/2021,Bill,8598,RR supplies,Janina Jakucewicz,138,NA,4459 Maintenance & Building Repairs:Janitorial Supplies,118,186.42,273023.59
,,,3/8/2021,Bill,8599,3122204,Constellation BG91704,127,NA,4410 Heating Fuel,61,2362.92,275386.51
,,,3/8/2021,Bill,8600,Mar - Apr,Comcast Business (TV) SFXS 1576,57,NA,4433 Other Utilities:Cable/Dish Services,65,85.12,275471.63
,,,3/8/2021,Bill,8601,56106,Printwell,418,NA,4152 Administrative Expenses:Outside Printing Cost,48,500,275971.63
,,,3/8/2021,Bill,8602,4026292062,"Savvas Learning Company, LLC",832,NA,-Split-,NA,268.92,276240.55
,,,3/8/2021,Bill,8603,1017530500,Pitney Bowes SFXS 0015503825,488,NA,4151 Administrative Expenses:Ofc Equipment-Supplies & Maint.,47,293.45,276534
,,,3/8/2021,Bill,8618,35476946,Johnson Controls SFX CH 7578,474,NA,4451 Maintenance & Building Repairs:Security,68,249.35,276783.35
,,,3/8/2021,Bill,8617,35476961,Johnson Controls SFX SCH 7898,473,NA,4451 Maintenance & Building Repairs:Security,68,215.91,276999.26
,,,3/8/2021,Bill,8616,3122253,Constellation BG92628,90,NA,4410 Heating Fuel,61,3572.47,280571.73
,,,3/8/2021,Bill,8615,Feb 20 - Mar 19,Comcast SFX Office 2331,142,NA,4434 Other Utilities:Internet/Computer Telecom Costs,66,130.61,280702.34
,,,3/8/2021,Bill,8614,Feb health insurance,Catholic Bishop of Chicago,4,NA,4030 Health Insurance-Employer Paid,163,38.5,280740.84
,,,3/8/2021,Bill,8613,1966149-00,Barton Cotton,895,NA,4151 Administrative Expenses:Ofc Equipment-Supplies & Maint.,47,252.51,280993.35
,,,3/8/2021,Bill,8612,11/25-12/29,Nicor SFX Sch,168,NA,4410 Heating Fuel,61,45.02,281038.37
,,,3/8/2021,Bill,8611,7017987,Loyola Press SFX SCH,400,NA,"4106 Books & Supplies,Non-Liturgical:Workbooks",688,937.44,281975.81
,,,3/8/2021,Bill,8610,3122257,Constellation BG92634,91,NA,4410 Heating Fuel,61,2391.37,284367.18
,,,3/8/2021,Bill,8609,69073,Crescent Cleaning Company,820,NA,-Split-,NA,17629.19,301996.37
,,,3/8/2021,Bill,8608,69167,Crescent Cleaning Company,820,NA,-Split-,NA,219.98,302216.35
,,,3/8/2021,Bill,8607,1/28 - 2/25,Nicor SJ Convent,12,NA,4410 Heating Fuel,61,1040.9,303257.25
,,,3/8/2021,Bill,8606,March dues,Chicago Tribune,222,NA,4807 Miscellaneous:Dues/Subscriptions,137,136,303393.25
,,,3/8/2021,Bill,8604,Jan 20- Feb 19,AT&T SJC YFF 2253,448,NA,4400 Telephone,60,82.65,303475.9
,,,3/8/2021,Bill,8605,9873632673,Verizon Wireless,118,NA,-Split-,NA,88.25,303564.15
,,,3/10/2021,Bill,8645,Feb Mass stipend,Canisius House Jesuit Community,450,NA,4012 Salaries:Extra Priests,576,100,303664.15
,,,3/10/2021,Bill,8646,Feb Mass stipend,Jesuit Community of Loyola University,360,NA,4012 Salaries:Extra Priests,576,200,303864.15
,,,3/10/2021,Bill,8647,Jan & Feb MA,Edward Harnett,121,NA,4253 Food Service & Meals:Meal Allowance,57,672,304536.15
,,,3/10/2021,Bill,8648,collections,St. Vincent De Paul,249,NA,6011.01 Share Collect Pay to Oth Parish:SS Joseph/Francis Xavier Sharin:St. Vincent de Paul,517,13302,317838.15
,,,3/10/2021,Bill,8649,collections,St. Thomas of Canterbury School,338,NA,6013.01 Share Collect Pay to Oth Parish:St Francis Xavier Sharing:St. Thomas of Canterbury,616,28221,346059.15
,,,3/10/2021,Bill,8650,145561,GO Technology Group Inc.,64,NA,4701 Furnishings & Equipment:Admin Furnishings/Equip,132,200,346259.15
,,,3/10/2021,Bill,8651,145604,GO Technology Group Inc.,64,NA,4151 Administrative Expenses:Ofc Equipment-Supplies & Maint.,47,1600,347859.15
,,,3/10/2021,Bill,8632,JC13187 adj,F.J. Kerrigan Plumbing Co. Inc,87,NA,4455 Maintenance & Building Repairs:Repairs to Buildings,115,1008.1,348867.25
,,,3/10/2021,Bill,8633,RR,Wayne Watts,241,NA,-Split-,NA,250.76,349118.01
,,,3/10/2021,Bill,8634,2/28 end statement,Millen Hardware,155,NA,4459 Maintenance & Building Repairs:Janitorial Supplies,118,248.54,349366.55
,,,3/10/2021,Bill,8635,office 365,Archdiocese of Chicago,96,NA,4156 Administrative Expenses:Computer Supplies,185,23.28,349389.83
,,,3/10/2021,Bill,8636,551793,Junior Library Guild,245,NA,"4107 Books & Supplies,Non-Liturgical:Library Materials",562,195,349584.83
,,,3/10/2021,Bill,8637,RR PD,Jaime Vehovsky,48,NA,4061 Prof. Growth/Minist./Other:Professional Growth,189,127,349711.83
,,,3/10/2021,Bill,8638,RR apple pencil,Patti Tsuru,886,NA,4156 Administrative Expenses:Computer Supplies,185,89,349800.83
,,,3/10/2021,Bill,8639,CSUM 134782,Garvey's Office Products,134,NA,-Split-,NA,1253.46,351054.29
,,,3/10/2021,Bill,8640,RR PD,Joanne Brinceanu,389,NA,4061 Prof. Growth/Minist./Other:Professional Growth,189,275,351329.29
,,,3/10/2021,Bill,8641,RR background check,George Weschler,291,NA,4157 Administrative Expenses:Criminal Background Checks,52,7,351336.29
,,,3/10/2021,Bill,8642,RR PD,Jennifer Miller,262,NA,4061 Prof. Growth/Minist./Other:Professional Growth,189,2200,353536.29
,,,3/10/2021,Bill,8643,1015,"Grage Management, LLC",487,NA,4514 Salaries:Special Program Teachers,578,700,354236.29
,,,3/10/2021,Bill,8644,2048127/2049612,"Schaefer's Wines, Foods & Spirits",56,NA,4252 Food Service & Meals:Food/Groceries,56,59.03,354295.32
,,,3/10/2021,Bill Payment (Check),3015,4176,Patti Tsuru,886,NA,1101.10 Cash:Saints JFX Oper. Acct. #2264:Checking Available,691,-89,354206.32
,,,3/10/2021,Bill Payment (Check),3016,4177,Pitney Bowes SFXS 0015503825,488,NA,1101.10 Cash:Saints JFX Oper. Acct. #2264:Checking Available,691,-293.45,353912.87
,,,3/10/2021,Bill Payment (Check),3017,4178,Printwell,418,NA,1101.10 Cash:Saints JFX Oper. Acct. #2264:Checking Available,691,-500,353412.87
,,,3/10/2021,Bill Payment (Check),3018,4179,"Savvas Learning Company, LLC",832,NA,1101.10 Cash:Saints JFX Oper. Acct. #2264:Checking Available,691,-268.92,353143.95
,,,3/10/2021,Bill Payment (Check),3020,4181,Scott Dolan,376,NA,1101.10 Cash:Saints JFX Oper. Acct. #2264:Checking Available,691,-200,352943.95
,,,3/10/2021,Bill Payment (Check),3021,4182,Scott Girard,375,NA,1101.10 Cash:Saints JFX Oper. Acct. #2264:Checking Available,691,-800,352143.95
,,,3/10/2021,Bill Payment (Check),3022,4183,Shephard Plumbing,154,NA,1101.10 Cash:Saints JFX Oper. Acct. #2264:Checking Available,691,-475,351668.95
,,,3/10/2021,Bill Payment (Check),3023,4184,Staples SJ,92,NA,1101.10 Cash:Saints JFX Oper. Acct. #2264:Checking Available,691,-440.19,351228.76
,,,3/10/2021,Bill Payment (Check),3026,4195,Wayne Watts,241,NA,1101.10 Cash:Saints JFX Oper. Acct. #2264:Checking Available,691,-250.76,350978
,,,3/10/2021,Bill Payment (Check),3027,4192,St. Thomas of Canterbury School,338,NA,101.25B Cash:Saints JFX Oper. Acct. #2264:Checking Restricted:Church Restricted:Sharing - St. Thomas School,657,-28221,322757
,,,3/10/2021,Bill Payment (Check),3028,4193,St. Vincent De Paul,249,NA,101.25E Cash:Saints JFX Oper. Acct. #2264:Checking Restricted:Church Restricted:SVDP,659,-13302,309455
,,,3/10/2021,Bill Payment (Check),3029,4191,"Virgil James, Inc",320,NA,1101.22 Cash:Saints JFX Oper. Acct. #2264:Checking Restricted:Building Restricted,587,-20676.82,288778.18
,,,3/10/2021,Bill Payment (Check),3030,NA,Catholic Bishop of Chicago (BillingSFXS),548,NA,1101.10 Cash:Saints JFX Oper. Acct. #2264:Checking Available,691,0,288778.18
,,,3/10/2021,Bill Payment (Check),3031,4196,Catholic Bishop of Chicago (BillingSFXS),548,NA,1101.10 Cash:Saints JFX Oper. Acct. #2264:Checking Available,691,-56539.75,232238.43
,,,3/10/2021,Bill Payment (Check),3032,4197,Catholic Bishop of Chicago (BillingSJS),547,NA,1101.10 Cash:Saints JFX Oper. Acct. #2264:Checking Available,691,-20494.93,211743.5
,,,3/10/2021,Bill Payment (Check),3033,4198,Catholic Bishop of Chicago (BillingSSJFX),359,NA,1101.10 Cash:Saints JFX Oper. Acct. #2264:Checking Available,691,-64372.7,147370.8
,,,3/10/2021,Bill Payment (Check),2989,4150,FP Mailing Solutions,114,NA,1101.10 Cash:Saints JFX Oper. Acct. #2264:Checking Available,691,-86.85,147283.95
,,,3/10/2021,Bill Payment (Check),2990,4151,FP Mailing Solutions SJS,381,NA,1101.10 Cash:Saints JFX Oper. Acct. #2264:Checking Available,691,-133.06,147150.89
,,,3/10/2021,Bill Payment (Check),2991,4152,Garvey's Office Products,134,NA,1101.10 Cash:Saints JFX Oper. Acct. #2264:Checking Available,691,-1253.46,145897.43
,,,3/10/2021,Bill Payment (Check),2992,4153,George Weschler,291,NA,1101.10 Cash:Saints JFX Oper. Acct. #2264:Checking Available,691,-7,145890.43
,,,3/10/2021,Bill Payment (Check),2993,4154,Gil Calderon,883,NA,1101.10 Cash:Saints JFX Oper. Acct. #2264:Checking Available,691,-100,145790.43
,,,3/10/2021,Bill Payment (Check),2994,4155,GO Technology Group Inc.,64,NA,1101.10 Cash:Saints JFX Oper. Acct. #2264:Checking Available,691,-1800,143990.43
,,,3/10/2021,Bill Payment (Check),2995,4156,"Grage Management, LLC",487,NA,1101.10 Cash:Saints JFX Oper. Acct. #2264:Checking Available,691,-700,143290.43
,,,3/10/2021,Bill Payment (Check),2996,4157,Illinois Office of the State Fire Marshal,508,NA,1101.10 Cash:Saints JFX Oper. Acct. #2264:Checking Available,691,-95,143195.43
,,,3/10/2021,Bill Payment (Check),2997,4158,Jaime Vehovsky,48,NA,1101.10 Cash:Saints JFX Oper. Acct. #2264:Checking Available,691,-127,143068.43
,,,3/10/2021,Bill Payment (Check),2998,4159,James Slater,882,NA,1101.10 Cash:Saints JFX Oper. Acct. #2264:Checking Available,691,-2400,140668.43
,,,3/10/2021,Bill Payment (Check),2999,4160,Janina Jakucewicz,138,NA,1101.10 Cash:Saints JFX Oper. Acct. #2264:Checking Available,691,-186.42,140482.01
,,,3/10/2021,Bill Payment (Check),3000,4161,Jennifer Miller,262,NA,1101.10 Cash:Saints JFX Oper. Acct. #2264:Checking Available,691,-2253,138229.01
,,,3/10/2021,Bill Payment (Check),3001,4162,Jesuit Community of Loyola University,360,NA,1101.10 Cash:Saints JFX Oper. Acct. #2264:Checking Available,691,-200,138029.01
,,,3/10/2021,Bill Payment (Check),3002,4163,Joanne Brinceanu,389,NA,1101.10 Cash:Saints JFX Oper. Acct. #2264:Checking Available,691,-275,137754.01
,,,3/10/2021,Bill Payment (Check),3003,4164,Johnson Controls SFX CH 7578,474,NA,1101.10 Cash:Saints JFX Oper. Acct. #2264:Checking Available,691,-249.35,137504.66
,,,3/10/2021,Bill Payment (Check),3004,4165,Johnson Controls SFX SCH 7898,473,NA,1101.10 Cash:Saints JFX Oper. Acct. #2264:Checking Available,691,-215.91,137288.75
,,,3/10/2021,Bill Payment (Check),3005,4166,Junior Library Guild,245,NA,1101.10 Cash:Saints JFX Oper. Acct. #2264:Checking Available,691,-195,137093.75
,,,3/10/2021,Bill Payment (Check),3006,4167,Kieran Stack,380,NA,1101.10 Cash:Saints JFX Oper. Acct. #2264:Checking Available,691,-300,136793.75
,,,3/10/2021,Bill Payment (Check),3007,4168,Loyola Press SFX SCH,400,NA,1101.10 Cash:Saints JFX Oper. Acct. #2264:Checking Available,691,-937.44,135856.31
,,,3/10/2021,Bill Payment (Check),3008,4169,Loyola Press YFF,833,NA,1101.10 Cash:Saints JFX Oper. Acct. #2264:Checking Available,691,-781.2,135075.11
,,,3/10/2021,Bill Payment (Check),3009,4170,Matt Hayes,379,NA,1101.10 Cash:Saints JFX Oper. Acct. #2264:Checking Available,691,-600,134475.11
,,,3/10/2021,Bill Payment (Check),3010,4171,Matt Lafontaine,378,NA,1101.10 Cash:Saints JFX Oper. Acct. #2264:Checking Available,691,-300,134175.11
,,,3/10/2021,Bill Payment (Check),3011,4172,Max Gunnill,377,NA,1101.10 Cash:Saints JFX Oper. Acct. #2264:Checking Available,691,-800,133375.11
,,,3/10/2021,Bill Payment (Check),3012,4173,Millen Hardware,155,NA,1101.10 Cash:Saints JFX Oper. Acct. #2264:Checking Available,691,-248.54,133126.57
,,,3/10/2021,Bill Payment (Check),3013,4174,Nicor SFX Sch,168,NA,1101.10 Cash:Saints JFX Oper. Acct. #2264:Checking Available,691,-45.02,133081.55
,,,3/10/2021,Bill Payment (Check),3014,4175,Nicor SJ Convent,12,NA,1101.10 Cash:Saints JFX Oper. Acct. #2264:Checking Available,691,-1040.9,132040.65
,,,3/10/2021,Bill Payment (Check),2956,4117,Advanced Disposal SFX Sch,60,NA,1101.10 Cash:Saints JFX Oper. Acct. #2264:Checking Available,691,-457.03,131583.62
,,,3/10/2021,Bill Payment (Check),2957,4118,Advanced Disposal SJ CH,108,NA,1101.10 Cash:Saints JFX Oper. Acct. #2264:Checking Available,691,-429.81,131153.81
,,,3/10/2021,Bill Payment (Check),2958,4119,Altorfer Industries Inc,867,NA,1101.10 Cash:Saints JFX Oper. Acct. #2264:Checking Available,691,-12796,118357.81
,,,3/10/2021,Bill Payment (Check),2959,4120,Amy Butterworth,119,NA,1101.10 Cash:Saints JFX Oper. Acct. #2264:Checking Available,691,-20,118337.81
,,,3/10/2021,Bill Payment (Check),2960,4121,Anderson Lock,185,NA,1101.10 Cash:Saints JFX Oper. Acct. #2264:Checking Available,691,-114,118223.81
,,,3/10/2021,Bill Payment (Check),2961,4122,Annie Buxton,623,NA,1101.10 Cash:Saints JFX Oper. Acct. #2264:Checking Available,691,-225,117998.81
,,,3/10/2021,Bill Payment (Check),2962,4123,Archdiocese of Chicago,96,NA,1101.10 Cash:Saints JFX Oper. Acct. #2264:Checking Available,691,-23.28,117975.53
,,,3/10/2021,Bill Payment (Check),2963,4124,AT&T SJC YFF 2253,448,NA,1101.10 Cash:Saints JFX Oper. Acct. #2264:Checking Available,691,-82.65,117892.88
,,,3/10/2021,Bill Payment (Check),2964,4125,Barton Cotton,895,NA,1101.10 Cash:Saints JFX Oper. Acct. #2264:Checking Available,691,-252.51,117640.37
,,,3/10/2021,Bill Payment (Check),2965,4126,Brian Roselle,885,NA,1101.10 Cash:Saints JFX Oper. Acct. #2264:Checking Available,691,-900,116740.37
,,,3/10/2021,Bill Payment (Check),2966,4127,Canisius House Jesuit Community,450,NA,1101.10 Cash:Saints JFX Oper. Acct. #2264:Checking Available,691,-100,116640.37
,,,3/10/2021,Bill Payment (Check),2967,4128,Canon,258,NA,1101.10 Cash:Saints JFX Oper. Acct. #2264:Checking Available,691,-1522,115118.37
,,,3/10/2021,Bill Payment (Check),2968,4129,Canon Maintanence,563,NA,1101.10 Cash:Saints JFX Oper. Acct. #2264:Checking Available,691,-647.37,114471
,,,3/10/2021,Bill Payment (Check),2969,4130,Canon SFX,524,NA,1101.10 Cash:Saints JFX Oper. Acct. #2264:Checking Available,691,-234,114237
,,,3/10/2021,Bill Payment (Check),2970,4131,Catholic Bishop of Chicago,4,NA,1101.10 Cash:Saints JFX Oper. Acct. #2264:Checking Available,691,-38.5,114198.5
,,,3/10/2021,Bill Payment (Check),2971,4132,Chicago Tribune,222,NA,1101.10 Cash:Saints JFX Oper. Acct. #2264:Checking Available,691,-136,114062.5
,,,3/10/2021,Bill Payment (Check),2972,4133,Chris Farr,884,NA,1101.10 Cash:Saints JFX Oper. Acct. #2264:Checking Available,691,-1100,112962.5
,,,3/10/2021,Bill Payment (Check),2973,4134,Comcast Business (TV) SFXS 1576,57,NA,1101.10 Cash:Saints JFX Oper. Acct. #2264:Checking Available,691,-85.12,112877.38
,,,3/10/2021,Bill Payment (Check),2974,4135,Comcast SFX Office 2331,142,NA,1101.10 Cash:Saints JFX Oper. Acct. #2264:Checking Available,691,-130.61,112746.77
,,,3/10/2021,Bill Payment (Check),2975,4136,Comcast SFX Rectory 2307,170,NA,1101.10 Cash:Saints JFX Oper. Acct. #2264:Checking Available,691,-238.01,112508.76
,,,3/10/2021,Bill Payment (Check),2976,4137,Constellation BG142404,128,NA,1101.10 Cash:Saints JFX Oper. Acct. #2264:Checking Available,691,-679.64,111829.12
,,,3/10/2021,Bill Payment (Check),2977,4138,Constellation BG91704,127,NA,1101.10 Cash:Saints JFX Oper. Acct. #2264:Checking Available,691,-2362.92,109466.2
,,,3/10/2021,Bill Payment (Check),2978,4139,Constellation BG91705,129,NA,1101.10 Cash:Saints JFX Oper. Acct. #2264:Checking Available,691,-666.99,108799.21
,,,3/10/2021,Bill Payment (Check),2979,4140,Constellation BG91706,130,NA,1101.10 Cash:Saints JFX Oper. Acct. #2264:Checking Available,691,-777.46,108021.75
,,,3/10/2021,Bill Payment (Check),2980,4141,Constellation BG92628,90,NA,1101.10 Cash:Saints JFX Oper. Acct. #2264:Checking Available,691,-3572.47,104449.28
,,,3/10/2021,Bill Payment (Check),2981,4142,Constellation BG92634,91,NA,1101.10 Cash:Saints JFX Oper. Acct. #2264:Checking Available,691,-2391.37,102057.91
,,,3/10/2021,Bill Payment (Check),2982,4143,Crescent Cleaning Company,820,NA,1101.10 Cash:Saints JFX Oper. Acct. #2264:Checking Available,691,-17849.17,84208.74
,,,3/10/2021,Bill Payment (Check),2983,4144,Daniel Mayall,85,NA,1101.10 Cash:Saints JFX Oper. Acct. #2264:Checking Available,691,-63,84145.74
,,,3/10/2021,Bill Payment (Check),2984,4145,Edward Harnett,121,NA,1101.10 Cash:Saints JFX Oper. Acct. #2264:Checking Available,691,-672,83473.74
,,,3/10/2021,Bill Payment (Check),2985,4146,Engie Resources Convent SJ,112,NA,1101.10 Cash:Saints JFX Oper. Acct. #2264:Checking Available,691,-250.52,83223.22
,,,3/10/2021,Bill Payment (Check),2986,4147,Engie Resources SJ Campus,111,NA,1101.10 Cash:Saints JFX Oper. Acct. #2264:Checking Available,691,-1598.82,81624.4
,,,3/10/2021,Bill Payment (Check),2987,4148,Engie SFX,253,NA,1101.10 Cash:Saints JFX Oper. Acct. #2264:Checking Available,691,-3869.28,77755.12
,,,3/10/2021,Bill Payment (Check),2988,4149,F.J. Kerrigan Plumbing Co. Inc,87,NA,1101.10 Cash:Saints JFX Oper. Acct. #2264:Checking Available,691,-1008.1,76747.02
,,,3/10/2021,Bill,7207,26344175,Canon,258,NA,-Split-,NA,1522,78269.02
,,,3/10/2021,Bill,7198,FB Squares,Matt Hayes,379,NA,4820 Miscellaneous:Other Miscellaneous Expense,311,600,78869.02
,,,3/10/2021,Bill,7199,FB Squares,Kieran Stack,380,NA,4820 Miscellaneous:Other Miscellaneous Expense,311,300,79169.02
,,,3/10/2021,Bill,7200,FB Squares,James Slater,882,NA,4820 Miscellaneous:Other Miscellaneous Expense,311,2400,81569.02
,,,3/10/2021,Bill,7201,FB Squares,Gil Calderon,883,NA,4820 Miscellaneous:Other Miscellaneous Expense,311,100,81669.02
,,,3/10/2021,Bill,7202,FB Squares,Chris Farr,884,NA,4820 Miscellaneous:Other Miscellaneous Expense,311,1100,82769.02
,,,3/10/2021,Bill,7203,FB Squares,Brian Roselle,885,NA,4820 Miscellaneous:Other Miscellaneous Expense,311,900,83669.02
,,,3/10/2021,Bill,7204,T40002564360,Advanced Disposal SFX Sch,60,NA,4432 Other Utilities:Scavenger Service,64,457.03,84126.05
,,,3/10/2021,Bill,7205,T40002564538,Advanced Disposal SJ CH,108,NA,-Split-,NA,429.81,84555.86
,,,3/10/2021,Bill,7206,8061346952,Staples SJ,92,NA,-Split-,NA,440.19,84996.05
,,,3/10/2021,Bill Payment (Check),3019,4180,"Schaefer's Wines, Foods & Spirits",56,NA,1101.10 Cash:Saints JFX Oper. Acct. #2264:Checking Available,691,-59.03,84937.02
,,,3/10/2021,Bill,7184,SFX doors final,"Virgil James, Inc",320,NA,6113.02 Capital Improvements:SFX Campus Cap Improvement:SFX Church Improvements,512,20676.82,105613.84
,,,3/10/2021,Bill,7185,7018395,Loyola Press YFF,833,NA,"4106 Books & Supplies,Non-Liturgical:Workbooks",688,781.2,106395.04
,,,3/10/2021,Bill,7186,RI104808702,FP Mailing Solutions,114,NA,4701 Furnishings & Equipment:Admin Furnishings/Equip,132,86.85,106481.89
,,,3/10/2021,Bill,7187,4035561858,Canon Maintanence,563,NA,4151 Administrative Expenses:Ofc Equipment-Supplies & Maint.,47,111.29,106593.18
,,,3/10/2021,Bill,7188,4035561859,Canon Maintanence,563,NA,4151 Administrative Expenses:Ofc Equipment-Supplies & Maint.,47,216.09,106809.27
,,,3/10/2021,Bill,7189,4035561857,Canon Maintanence,563,NA,4151 Administrative Expenses:Ofc Equipment-Supplies & Maint.,47,11.1,106820.37
,,,3/10/2021,Bill,7190,4035560484,Canon Maintanence,563,NA,4151 Administrative Expenses:Ofc Equipment-Supplies & Maint.,47,308.89,107129.26
,,,3/10/2021,Bill,7191,3982813,Engie Resources Convent SJ,112,NA,4420 Electricity,62,250.52,107379.78
,,,3/10/2021,Bill,7192,3982838,Engie Resources SJ Campus,111,NA,-Split-,NA,1598.82,108978.6
,,,3/10/2021,Bill,7193,3982794,Engie SFX,253,NA,-Split-,NA,3869.28,112847.88
,,,3/10/2021,Bill,7194,FB squares,Scott Girard,375,NA,4820 Miscellaneous:Other Miscellaneous Expense,311,800,113647.88
,,,3/10/2021,Bill,7195,FB squares,Scott Dolan,376,NA,4820 Miscellaneous:Other Miscellaneous Expense,311,200,113847.88
,,,3/10/2021,Bill,7196,FB Squares,Max Gunnill,377,NA,4820 Miscellaneous:Other Miscellaneous Expense,311,800,114647.88
,,,3/10/2021,Bill,7197,FB Squares,Matt Lafontaine,378,NA,4820 Miscellaneous:Other Miscellaneous Expense,311,300,114947.88
,,,3/10/2021,Bill Payment (Check),3024,4185,The New York Times,140,NA,1101.10 Cash:Saints JFX Oper. Acct. #2264:Checking Available,691,-6,114941.88
,,,3/10/2021,Bill Payment (Check),3025,4186,Verizon Wireless,118,NA,1101.10 Cash:Saints JFX Oper. Acct. #2264:Checking Available,691,-88.25,114853.63
2010 Procurement Card Payable,381,,,,,,,,,,,,
,,-4664.01,,,,,,,,,,,
2010.01 SSJFX,610,,,,,,,,,,,,
,,-8748.96,,,,,,,,,,,
,,,1/27/2021,Bill,8449,Dec - Jan statement,Bank of America 4433,26,NA,2000 Accounts Payable,217,-7173.94,-15922.9
2010.02 SJS,682,,,,,,,,,,,,
,,-4069.86,,,,,,,,,,,
2010.03 SFXS,611,,,,,,,,,,,,
,,-5499.81,,,,,,,,,,,
,,,1/11/2021,Bill,8375,Nov - Dec 2020,Bank of America SFX 5830,296,NA,2000 Accounts Payable,217,-4815.28,-10315.09
,,,1/27/2021,Bill,8450,Dec - Jan Statement,Bank of America SFX 5830,296,NA,2000 Accounts Payable,217,-7884.76,-18199.85
2200 Other Payroll Withholdings,443,,,,,,,,,,,,
2204 Employee Health Ins. Withheld,NA,,,,,,,,,,,,
2204.02 SJ Payroll Health Deductions,NA,,,,,,,,,,,,
,,-7241.85,,,,,,,,,,,
,,,1/8/2021,Journal Entry,10563,PP01082021,NA,NA,SJ Medical Deductions,-Split-,NA,1306,-5935.85
,,,1/8/2021,Journal Entry,10563,PP01082021,NA,NA,SJ Medical Deductions,-Split-,NA,942.61,-4993.24
,,,1/22/2021,Journal Entry,10564,PP01222021,NA,NA,SJ Medical Sweep,-Split-,NA,-1620,-6613.24
,,,1/22/2021,Journal Entry,10564,PP01222021,NA,NA,SJ Medical Deductions,-Split-,NA,942.61,-5670.63
,,,1/22/2021,Journal Entry,10564,PP01222021,NA,NA,SJ Medical Deductions,-Split-,NA,1306,-4364.63
,,,1/22/2021,Journal Entry,10564,PP01222021,NA,NA,SJ Medical Sweep,-Split-,NA,-2612,-6976.63
,,,2/5/2021,Journal Entry,10587,PP02052021,NA,NA,SJ Medical Deductions,-Split-,NA,1306,-5670.63
,,,2/5/2021,Journal Entry,10587,PP02052021,NA,NA,SJ Medical Deductions,-Split-,NA,942.61,-4728.02
,,,2/19/2021,Journal Entry,10588,PP02192021,NA,NA,SJ Medical Deductions,-Split-,NA,1306,-3422.02
,,,2/19/2021,Journal Entry,10588,PP02192021,NA,NA,SJ Medical Sweep,-Split-,NA,-2612,-6034.02
,,,2/19/2021,Journal Entry,10588,PP02192021,NA,NA,SJ Medical Sweep,-Split-,NA,-1620,-7654.02
,,,2/19/2021,Journal Entry,10588,PP02192021,NA,NA,SJ Medical Deductions,-Split-,NA,942.61,-6711.41
,,,3/5/2021,Journal Entry,11030,PP20210305,NA,NA,SJ Medical Deductions,-Split-,NA,942.61,-5768.8
,,,3/5/2021,Journal Entry,11030,PP20210305,NA,NA,SJ Medical Deductions,-Split-,NA,1306,-4462.8
2204.03 SFX Payroll Health Deductions,444,,,,,,,,,,,,
,,-7347.19,,,,,,,,,,,
,,,1/8/2021,Journal Entry,10565,PP01082021,NA,NA,SFX Medical Deductions,-Split-,NA,5046.44,-2300.75
,,,1/8/2021,Journal Entry,10565,PP01082021,NA,NA,SFX Medical Deductions,-Split-,NA,1000,-1300.75
,,,1/8/2021,Journal Entry,10565,PP01082021,NA,NA,SFX Medical Deductions,-Split-,NA,27,-1273.75
,,,1/22/2021,Journal Entry,10567,PP01222021,NA,NA,SFX Medical Deductions,-Split-,NA,27,-1246.75
,,,1/22/2021,Journal Entry,10567,PP01222021,NA,NA,SFX Medical Deductions,-Split-,NA,5208.44,3961.69
,,,1/22/2021,Journal Entry,10567,PP01222021,NA,NA,SFX Medical Sweep,-Split-,NA,-2000,1961.69
,,,1/22/2021,Journal Entry,10567,PP01222021,NA,NA,SFX Medical Deductions,-Split-,NA,1000,2961.69
,,,1/22/2021,Journal Entry,10567,PP01222021,NA,NA,SFX Medical Sweep,-Split-,NA,-10336,-7374.31
,,,2/5/2021,Journal Entry,10589,PP02192022,NA,NA,SFX Medical Deductions,-Split-,NA,27,-7347.31
,,,2/5/2021,Journal Entry,10589,PP02192022,NA,NA,SFX Medical Deductions,-Split-,NA,5742.69,-1604.62
,,,2/5/2021,Journal Entry,10589,PP02192022,NA,NA,SFX Medical Deductions,-Split-,NA,1000,-604.62
,,,2/19/2021,Journal Entry,10590,PP02192021,NA,NA,SFX Medical Deductions,-Split-,NA,5318.69,4714.07
,,,2/19/2021,Journal Entry,10590,PP02192021,NA,NA,SFX Medical Sweep,-Split-,NA,-2000,2714.07
,,,2/19/2021,Journal Entry,10590,PP02192021,NA,NA,SFX Medical Deductions,-Split-,NA,1000,3714.07
,,,2/19/2021,Journal Entry,10590,PP02192021,NA,NA,SFX Medical Deductions,-Split-,NA,27,3741.07
,,,2/19/2021,Journal Entry,10590,PP02192021,NA,NA,SFX Medical Sweep,-Split-,NA,-10120,-6378.93
,,,3/5/2021,Journal Entry,11029,PP20210305,NA,NA,SFX Medical Deductions,-Split-,NA,5073.44,-1305.49
,,,3/5/2021,Journal Entry,11029,PP20210305,NA,NA,SFX Medical Deductions,-Split-,NA,1000,-305.49
,,,3/5/2021,Journal Entry,11029,PP20210305,NA,NA,SFX Medical Deductions,-Split-,NA,27,-278.49
2205 Employee Dental Ins. Co-Pay,445,,,,,,,,,,,,
2205.02 SJ Payroll Dental Deductions,NA,,,,,,,,,,,,
,,-1241.6,,,,,,,,,,,
,,,1/8/2021,Journal Entry,10563,PP01082021,NA,NA,SJ Dental Deductions,-Split-,NA,222.75,-1018.85
,,,1/8/2021,Journal Entry,10563,PP01082021,NA,NA,SJ Dental Deductions,-Split-,NA,192.88,-825.97
,,,1/22/2021,Journal Entry,10564,PP01222021,NA,NA,SJ Dental Sweep,-Split-,NA,-335.5,-1161.47
,,,1/22/2021,Journal Entry,10564,PP01222021,NA,NA,SJ Dental Deductions,-Split-,NA,222.75,-938.72
,,,1/22/2021,Journal Entry,10564,PP01222021,NA,NA,SJ Dental Deductions,-Split-,NA,192.88,-745.84
,,,1/22/2021,Journal Entry,10564,PP01222021,NA,NA,SJ Dental Sweep,-Split-,NA,-445.5,-1191.34
,,,2/5/2021,Journal Entry,10587,PP02052021,NA,NA,SJ Dental Deductions,-Split-,NA,222.75,-968.59
,,,2/5/2021,Journal Entry,10587,PP02052021,NA,NA,SJ Dental Deductions,-Split-,NA,192.88,-775.71
,,,2/19/2021,Journal Entry,10588,PP02192021,NA,NA,SJ Dental Sweep,-Split-,NA,-445.5,-1221.21
,,,2/19/2021,Journal Entry,10588,PP02192021,NA,NA,SJ Dental Deductions,-Split-,NA,222.75,-998.46
,,,2/19/2021,Journal Entry,10588,PP02192021,NA,NA,SJ Dental Deductions,-Split-,NA,192.88,-805.58
,,,2/19/2021,Journal Entry,10588,PP02192021,NA,NA,SJ Dental Sweep,-Split-,NA,-335.5,-1141.08
,,,3/5/2021,Journal Entry,11030,PP20210305,NA,NA,SJ Dental Deductions,-Split-,NA,222.75,-918.33
,,,3/5/2021,Journal Entry,11030,PP20210305,NA,NA,SJ Dental Deductions,-Split-,NA,192.88,-725.45
2205.03 SFX Payroll Dental Deductions,446,,,,,,,,,,,,
,,673.16,,,,,,,,,,,
,,,1/8/2021,Journal Entry,10565,PP01082021,NA,NA,SFX Dental Deductions,-Split-,NA,927.7,1600.86
,,,1/8/2021,Journal Entry,10565,PP01082021,NA,NA,SFX Dental Deductions,-Split-,NA,217,1817.86
,,,1/22/2021,Journal Entry,10567,PP01222021,NA,NA,SFX Dental Sweep,-Split-,NA,-472.5,1345.36
,,,1/22/2021,Journal Entry,10567,PP01222021,NA,NA,SFX Dental Deductions,-Split-,NA,217,1562.36
,,,1/22/2021,Journal Entry,10567,PP01222021,NA,NA,SFX Dental Deductions,-Split-,NA,968.2,2530.56
,,,1/22/2021,Journal Entry,10567,PP01222021,NA,NA,SFX Dental Sweep,-Split-,NA,-1906,624.56
,,,2/5/2021,Journal Entry,10589,PP02192022,NA,NA,SFX Dental Deductions,-Split-,NA,217,841.56
,,,2/5/2021,Journal Entry,10589,PP02192022,NA,NA,SFX Dental Deductions,-Split-,NA,1071.95,1913.51
,,,2/19/2021,Journal Entry,10590,PP02192021,NA,NA,SFX Dental Deductions,-Split-,NA,217,2130.51
,,,2/19/2021,Journal Entry,10590,PP02192021,NA,NA,SFX Dental Deductions,-Split-,NA,975.7,3106.21
,,,2/19/2021,Journal Entry,10590,PP02192021,NA,NA,SFX Dental Sweep,-Split-,NA,-395.5,2710.71
,,,2/19/2021,Journal Entry,10590,PP02192021,NA,NA,SFX Dental Sweep,-Split-,NA,-1852,858.71
,,,3/5/2021,Journal Entry,11029,PP20210305,NA,NA,SFX Dental Deductions,-Split-,NA,217,1075.71
,,,3/5/2021,Journal Entry,11029,PP20210305,NA,NA,SFX Dental Deductions,-Split-,NA,934.45,2010.16
2300 Archdiocesan Obligations,473,,,,,,,,,,,,
2313 Principal/Interest Due on Loan,NA,,,,,,,,,,,,
2313.87 SJ Church FY17 A/R Balance Prin,NA,,,,,,,,,,,,
,,45932.88,,,,,,,,,,,
2313.89 SJ Church FY18 A/R Balance Prin,415,,,,,,,,,,,,
,,159754.5,,,,,,,,,,,
2313.91 SJ Church FY19 A/R Balance Prin,417,,,,,,,,,,,,
,,102846.12,,,,,,,,,,,
2313.92 SJ Church FY19 A/R Balance Int,418,,,,,,,,,,,,
,,2566.81,,,,,,,,,,,
2313.93 SJ School FY17 A/R Balance Prin,468,,,,,,,,,,,,
,,51112,,,,,,,,,,,
2313.95 SJ School FY18 A/R Balance Prin,469,,,,,,,,,,,,
,,179662,,,,,,,,,,,
2313.97 SJ School FY19 A/R Balance Prin,471,,,,,,,,,,,,
,,169669.22,,,,,,,,,,,
2313.98 SJ School FY19 A/R Balance Int,472,,,,,,,,,,,,
,,2838.72,,,,,,,,,,,
2475 Parish SBA - PPP Proceeds,452,,,,,,,,,,,,
2475.10 Church SBA Â– PPP Proceeds,NA,,,,,,,,,,,,
2475.11 St. Joseph,NA,,,,,,,,,,,,
,,118152.75,,,,,,,,,,,
2475.12 St. Francis Xavier,453,,,,,,,,,,,,
,,189616.64,,,,,,,,,,,
2475.20 School SBA Â– PPP Proceeds,454,,,,,,,,,,,,
2475.21 St. Joseph,NA,,,,,,,,,,,,
,,142519.25,,,,,,,,,,,
2475.22 St. Francis Xavier,455,,,,,,,,,,,,
,,675048.36,,,,,,,,,,,
2500 Other Current Liabilities,480,,,,,,,,,,,,
2540 Old QB to Merged File Accrual,NA,,,,,,,,,,,,
2542 St Francis Xavier Accrual,NA,,,,,,,,,,,,
2542.04 Funds Held St. Thomas School,NA,,,,,,,,,,,,
,,1991.16,,,,,,,,,,,
2542.05 Funds for St. Thomas FoodPantry,481,,,,,,,,,,,,
,,2460,,,,,,,,,,,
2542.07 SFX School Technology Fund,482,,,,,,,,,,,,
,,62705.27,,,,,,,,,,,
2542.08 SFX Undesignated Scholar/Proj,483,,,,,,,,,,,,
,,221972.77,,,,,,,,,,,
2542.09 SFX EPIC Fund,484,,,,,,,,,,,,
,,134244,,,,,,,,,,,
2542.10 SFX School Fund the Need,485,,,,,,,,,,,,
,,302198,,,,,,,,,,,
2542.11 SFX School Teacher Development,486,,,,,,,,,,,,
,,38552.75,,,,,,,,,,,
2542.12 SFX School Events,487,,,,,,,,,,,,
,,33366,,,,,,,,,,,
2703 Opening Bal Equity,202,,,,,,,,,,,,
,,5065889.96,,,,,,,,,,,
3000 Sunday and Holy Day Collections,107,,,,,,,,,,,,
,,225,,,,,,,,,,,
3900 Retained Earnings,393,,,,,,,,,,,,
,,-1077882.02,,,,,,,,,,,
3000 Sunday and Holy Day Collections,278,,,,,,,,,,,,
3011 Sunday Collection,NA,,,,,,,,,,,,
3012 Sunday Collection Envelopes,NA,,,,,,,,,,,,
,,379172.04,,,,,,,,,,,
,,,1/3/2021,Journal Entry,10570,SUN 210103,NA,NA,NA,-Split-,NA,10252.7,389424.74
,,,1/7/2021,Journal Entry,10586,210107 MD,NA,NA,NA,-Split-,NA,675,390099.74
,,,1/10/2021,Journal Entry,10572,SPEC 210110,NA,NA,NA,-Split-,NA,3491.66,393591.4
,,,1/10/2021,Deposit,4162,NA,NA,NA,NA,1101.10 Cash:Saints JFX Oper. Acct. #2264:Checking Available,691,10715,404306.4
,,,1/12/2021,Journal Entry,10574,MD 210112,NA,NA,NA,-Split-,NA,68,404374.4
,,,1/17/2021,Journal Entry,10575,SUN 210117,NA,NA,NA,-Split-,NA,6177,410551.4
,,,1/18/2021,Journal Entry,10576,MD 210118,NA,NA,NA,-Split-,NA,1000,411551.4
,,,1/22/2021,Journal Entry,10577,MD 210122,NA,NA,NA,-Split-,NA,3570,415121.4
,,,1/24/2021,Journal Entry,10578,SUN 210124,NA,NA,NA,-Split-,NA,6523,421644.4
,,,1/31/2021,Journal Entry,10582,SUNC 210131,NA,NA,NA,-Split-,NA,7763,429407.4
,,,2/3/2021,Journal Entry,10583,MD 210203,NA,NA,NA,-Split-,NA,8165,437572.4
,,,2/7/2021,Journal Entry,10783,SUN 210207,NA,NA,NA,-Split-,NA,6951,444523.4
,,,2/11/2021,Journal Entry,11024,md210211,NA,NA,NA,-Split-,NA,3713.66,448237.06
,,,2/14/2021,Journal Entry,10799,SUN210214,NA,NA,NA,-Split-,NA,5648,453885.06
,,,2/19/2021,Journal Entry,11025,MD210219,NA,NA,NA,-Split-,NA,23215,477100.06
,,,2/21/2021,Journal Entry,10800,SUN210221,NA,NA,NA,-Split-,NA,5936,483036.06
,,,2/23/2021,Journal Entry,11026,MD210223,NA,NA,NA,-Split-,NA,4690,487726.06
,,,2/24/2021,Journal Entry,11027,MD210224,NA,NA,NA,-Split-,NA,1120,488846.06
,,,2/28/2021,Journal Entry,10802,SUN210228,NA,NA,NA,-Split-,NA,7761,496607.06
3013 Sunday Collection Loose Ck/Cash,279,,,,,,,,,,,,
,,1376,,,,,,,,,,,
3013.1 Counting Error,692,,,,,,,,,,,,
,,155,,,,,,,,,,,
,,,1/3/2021,Journal Entry,10570,SUN 210103,NA,NA,Bank Error refund,-Split-,NA,47.45,202.45
,,,1/12/2021,Deposit,4444,NA,NA,NA,NA,1101.10 Cash:Saints JFX Oper. Acct. #2264:Checking Available,691,250,452.45
3014 Sunday Collections E-Giving,406,,,,,,,,,,,,
,,513027.9,,,,,,,,,,,
,,,1/1/2021,Journal Entry,10581,GC 210101,NA,NA,NA,-Split-,NA,83735.18,596763.08
,,,1/6/2021,Deposit,4452,NA,NA,NA,NA,1106.01 Cash:Old St. Joseph Accounts:St. Joseph #XXXX Oper (Old) BMO,330,95,596858.08
,,,1/19/2021,Deposit,4445,NA,NA,NA,NA,1101.10 Cash:Saints JFX Oper. Acct. #2264:Checking Available,691,160.01,597018.09
,,,1/21/2021,Deposit,4166,NA,NA,NA,NA,1240.02 Oper. Savings at the Arch Bank:Stock Savings Account:SFX Stock/Mut Fund #701430250,651,1979.94,598998.03
,,,2/1/2021,Journal Entry,11028,GC FEB 2021,NA,NA,NA,-Split-,NA,78356.08,677354.11
,,,2/1/2021,Deposit,4463,NA,NA,NA,NA,1101.10 Cash:Saints JFX Oper. Acct. #2264:Checking Available,691,80,677434.11
3015 Holy Day Collection,281,,,,,,,,,,,,
3016 Holy Day Collection Envelopes,NA,,,,,,,,,,,,
,,2561,,,,,,,,,,,
,,,1/3/2021,Journal Entry,10570,SUN 210103,NA,NA,Assumption,-Split-,NA,1,2562
,,,1/3/2021,Journal Entry,10570,SUN 210103,NA,NA,Immac Conc,-Split-,NA,50,2612
,,,1/3/2021,Journal Entry,10570,SUN 210103,NA,NA,Sol of Mary,-Split-,NA,893,3505
,,,1/7/2021,Journal Entry,10586,210107 MD,NA,NA,NA,-Split-,NA,40,3545
,,,1/10/2021,Journal Entry,10572,SPEC 210110,NA,NA,NA,-Split-,NA,130,3675
,,,1/10/2021,Journal Entry,10572,SPEC 210110,NA,NA,Initial offering,-Split-,NA,450,4125
,,,1/17/2021,Journal Entry,10575,SUN 210117,NA,NA,initial offering,-Split-,NA,530,4655
,,,1/24/2021,Journal Entry,10578,SUN 210124,NA,NA,Initial offering,-Split-,NA,25,4680
,,,2/3/2021,Journal Entry,10583,MD 210203,NA,NA,initial offering,-Split-,NA,20,4700
,,,2/3/2021,Journal Entry,10583,MD 210203,NA,NA,ash wed,-Split-,NA,10,4710
,,,2/7/2021,Journal Entry,10783,SUN 210207,NA,NA,NA,-Split-,NA,33,4743
,,,2/11/2021,Journal Entry,11024,md210211,NA,NA,NA,-Split-,NA,10,4753
,,,2/14/2021,Journal Entry,10799,SUN210214,NA,NA,NA,-Split-,NA,395,5148
,,,2/24/2021,Journal Entry,11027,MD210224,NA,NA,NA,-Split-,NA,10,5158
,,,2/28/2021,Journal Entry,10802,SUN210228,NA,NA,NA,-Split-,NA,200,5358
,,,2/28/2021,Journal Entry,10802,SUN210228,NA,NA,NA,-Split-,NA,50,5408
3017 Holy Day Collect. Loose Ck/Cash,280,,,,,,,,,,,,
,,453,,,,,,,,,,,
,,,1/31/2021,Journal Entry,10582,SUNC 210131,NA,NA,NA,-Split-,NA,115,568
3020 Christmas Collection,110,,,,,,,,,,,,
,,283424,,,,,,,,,,,
,,,1/1/2021,Journal Entry,10581,GC 210101,NA,NA,NA,-Split-,NA,18475,301899
,,,1/4/2021,Deposit,4443,NA,NA,NA,NA,1101.10 Cash:Saints JFX Oper. Acct. #2264:Checking Available,691,22417,324316
,,,1/5/2021,Deposit,4442,NA,NA,NA,NA,1101.10 Cash:Saints JFX Oper. Acct. #2264:Checking Available,691,7500,331816
,,,1/7/2021,Journal Entry,10586,210107 MD,NA,NA,NA,-Split-,NA,7500,339316
,,,1/10/2021,Journal Entry,10572,SPEC 210110,NA,NA,NA,-Split-,NA,100,339416
,,,1/12/2021,Journal Entry,10574,MD 210112,NA,NA,NA,-Split-,NA,1012,340428
,,,1/17/2021,Journal Entry,10575,SUN 210117,NA,NA,NA,-Split-,NA,900,341328
,,,1/18/2021,Journal Entry,10576,MD 210118,NA,NA,NA,-Split-,NA,3000,344328
,,,1/22/2021,Journal Entry,10577,MD 210122,NA,NA,NA,-Split-,NA,2000,346328
,,,1/24/2021,Journal Entry,10578,SUN 210124,NA,NA,NA,-Split-,NA,150,346478
,,,1/31/2021,Journal Entry,10582,SUNC 210131,NA,NA,NA,-Split-,NA,500,346978
,,,2/1/2021,Journal Entry,11028,GC FEB 2021,NA,NA,NA,-Split-,NA,750,347728
,,,2/7/2021,Journal Entry,10783,SUN 210207,NA,NA,NA,-Split-,NA,250,347978
,,,2/11/2021,Journal Entry,11024,md210211,NA,NA,NA,-Split-,NA,150,348128
,,,2/14/2021,Journal Entry,10799,SUN210214,NA,NA,NA,-Split-,NA,50,348178
,,,2/24/2021,Journal Entry,11027,MD210224,NA,NA,NA,-Split-,NA,2000,350178
,,,2/28/2021,Journal Entry,10802,SUN210228,NA,NA,NA,-Split-,NA,150,350328
3030 Easter Collection,111,,,,,,,,,,,,
,,175,,,,,,,,,,,
,,,2/24/2021,Journal Entry,11027,MD210224,NA,NA,NA,-Split-,NA,75,250
,,,2/28/2021,Journal Entry,10802,SUN210228,NA,NA,NA,-Split-,NA,500,750
3040 Other Collections,558,,,,,,,,,,,,
3042 Flowers Collection,NA,,,,,,,,,,,,
,,1173,,,,,,,,,,,
3043 School Support Collection,282,,,,,,,,,,,,
,,,2/1/2021,Journal Entry,11028,GC FEB 2021,NA,NA,NA,-Split-,NA,140,140
3045 Almsgiving,369,,,,,,,,,,,,
,,,2/1/2021,Journal Entry,11028,GC FEB 2021,NA,NA,ASH,-Split-,NA,1400,1400
,,,2/11/2021,Journal Entry,11024,md210211,NA,NA,ASH,-Split-,NA,40,1440
,,,2/14/2021,Journal Entry,10799,SUN210214,NA,NA,ASH,-Split-,NA,60,1500
,,,2/17/2021,Deposit,4453,NA,NA,NA,NA,101.25J Cash:Saints JFX Oper. Acct. #2264:Checking Restricted:Church Restricted:Alms Giving,683,4038,5538
,,,2/19/2021,Journal Entry,11025,MD210219,NA,NA,ASH,-Split-,NA,75,5613
,,,2/24/2021,Journal Entry,11027,MD210224,NA,NA,ash,-Split-,NA,70,5683
,,,2/28/2021,Journal Entry,10802,SUN210228,NA,NA,ASH,-Split-,NA,145,5828
3100 Tuition,392,,,,,,,,,,,,
,,1100,,,,,,,,,,,
3101 Tuition - Current,698,,,,,,,,,,,,
,,2230739.2,,,,,,,,,,,
,,,1/1/2021,Deposit,4352,NA,NA,NA,ps-jk,1101.10 Cash:Saints JFX Oper. Acct. #2264:Checking Available,691,2194.5,2232933.7
,,,1/1/2021,Journal Entry,10581,GC 210101,NA,NA,NA,-Split-,NA,5247,2238180.7
,,,1/3/2021,Journal Entry,10570,SUN 210103,NA,NA,NA,-Split-,NA,3785,2241965.7
,,,1/5/2021,Deposit,4173,NA,NA,NA,ASC,1101.10 Cash:Saints JFX Oper. Acct. #2264:Checking Available,691,238,2242203.7
,,,1/5/2021,Deposit,4167,NA,NA,NA,k-8,1101.10 Cash:Saints JFX Oper. Acct. #2264:Checking Available,691,2060,2244263.7
,,,1/5/2021,Deposit,4173,NA,NA,NA,k-8,1101.10 Cash:Saints JFX Oper. Acct. #2264:Checking Available,691,783.56,2245047.26
,,,1/8/2021,Deposit,4168,NA,NA,NA,k-8,1101.10 Cash:Saints JFX Oper. Acct. #2264:Checking Available,691,5862.82,2250910.08
,,,1/8/2021,Deposit,4168,NA,NA,NA,ps-jk,1101.10 Cash:Saints JFX Oper. Acct. #2264:Checking Available,691,1092.14,2252002.22
,,,1/8/2021,Deposit,4168,NA,NA,NA,scholarship,1101.10 Cash:Saints JFX Oper. Acct. #2264:Checking Available,691,-550,2251452.22
,,,1/12/2021,Bill,8078,RR tuition overpaid,Eileen and Kevin O'Hara,874,NA,2000 Accounts Payable,217,-800,2250652.22
,,,1/15/2021,Deposit,4169,NA,NA,NA,monthly school disc,1101.10 Cash:Saints JFX Oper. Acct. #2264:Checking Available,691,-151.74,2250500.48
,,,1/15/2021,Deposit,4169,NA,NA,NA,scholarship,1101.10 Cash:Saints JFX Oper. Acct. #2264:Checking Available,691,-2541.38,2247959.1
,,,1/15/2021,Deposit,4169,NA,NA,NA,staff disc,1101.10 Cash:Saints JFX Oper. Acct. #2264:Checking Available,691,-3062.57,2244896.53
,,,1/15/2021,Deposit,4169,NA,NA,NA,ASC,1101.10 Cash:Saints JFX Oper. Acct. #2264:Checking Available,691,697,2245593.53
,,,1/15/2021,Deposit,4174,NA,NA,NA,ECS,1101.10 Cash:Saints JFX Oper. Acct. #2264:Checking Available,691,801,2246394.53
,,,1/15/2021,Deposit,4174,NA,NA,NA,k-8,1101.10 Cash:Saints JFX Oper. Acct. #2264:Checking Available,691,15984.53,2262379.06
,,,1/15/2021,Deposit,4174,NA,NA,NA,ps-jk,1101.10 Cash:Saints JFX Oper. Acct. #2264:Checking Available,691,22012.77,2284391.83
,,,1/15/2021,Deposit,4169,NA,NA,NA,k-8,1101.10 Cash:Saints JFX Oper. Acct. #2264:Checking Available,691,93196.45,2377588.28
,,,1/15/2021,Deposit,4169,NA,NA,NA,ps-jk,1101.10 Cash:Saints JFX Oper. Acct. #2264:Checking Available,691,18998.19,2396586.47
,,,1/18/2021,Journal Entry,10576,MD 210118,NA,NA,O'Brien,-Split-,NA,4771.5,2401357.97
,,,1/18/2021,Journal Entry,10576,MD 210118,NA,NA,O'Brien,-Split-,NA,6390,2407747.97
,,,1/20/2021,Deposit,4175,NA,NA,NA,ps-jk,1101.10 Cash:Saints JFX Oper. Acct. #2264:Checking Available,691,1984,2409731.97
,,,1/20/2021,Deposit,4170,NA,NA,NA,ps-jk,1101.10 Cash:Saints JFX Oper. Acct. #2264:Checking Available,691,8835.98,2418567.95
,,,1/20/2021,Deposit,4170,NA,NA,NA,k-8,1101.10 Cash:Saints JFX Oper. Acct. #2264:Checking Available,691,35008.87,2453576.82
,,,1/20/2021,Deposit,4170,NA,NA,NA,staff disc,1101.10 Cash:Saints JFX Oper. Acct. #2264:Checking Available,691,-660.55,2452916.27
,,,1/20/2021,Deposit,4170,NA,NA,NA,ASC,1101.10 Cash:Saints JFX Oper. Acct. #2264:Checking Available,691,163,2453079.27
,,,1/25/2021,Deposit,4176,NA,NA,NA,scholarship,1101.10 Cash:Saints JFX Oper. Acct. #2264:Checking Available,691,-429.44,2452649.83
,,,1/25/2021,Deposit,4176,NA,NA,NA,payment reallocation,1101.10 Cash:Saints JFX Oper. Acct. #2264:Checking Available,691,-182.3,2452467.53
,,,1/25/2021,Deposit,4176,NA,NA,NA,k-8,1101.10 Cash:Saints JFX Oper. Acct. #2264:Checking Available,691,4211.62,2456679.15
,,,1/25/2021,Deposit,4176,NA,NA,NA,ps-jk,1101.10 Cash:Saints JFX Oper. Acct. #2264:Checking Available,691,12035.41,2468714.56
,,,1/25/2021,Deposit,4172,NA,NA,NA,NA,1101.10 Cash:Saints JFX Oper. Acct. #2264:Checking Available,691,40,2468754.56
,,,1/25/2021,Deposit,4171,NA,NA,NA,ASC,1101.10 Cash:Saints JFX Oper. Acct. #2264:Checking Available,691,50,2468804.56
,,,1/25/2021,Deposit,4171,NA,NA,NA,scholarship,1101.10 Cash:Saints JFX Oper. Acct. #2264:Checking Available,691,-4299.04,2464505.52
,,,1/25/2021,Deposit,4171,NA,NA,NA,staff disc,1101.10 Cash:Saints JFX Oper. Acct. #2264:Checking Available,691,-3830.45,2460675.07
,,,1/25/2021,Deposit,4171,NA,NA,NA,k-8,1101.10 Cash:Saints JFX Oper. Acct. #2264:Checking Available,691,212355.93,2673031
,,,1/25/2021,Deposit,4171,NA,NA,NA,ps-jk,1101.10 Cash:Saints JFX Oper. Acct. #2264:Checking Available,691,27863.27,2700894.27
,,,1/25/2021,Deposit,4176,NA,NA,NA,extended day,1101.10 Cash:Saints JFX Oper. Acct. #2264:Checking Available,691,754,2701648.27
,,,1/29/2021,Deposit,4178,NA,NA,NA,ps-jk,1101.10 Cash:Saints JFX Oper. Acct. #2264:Checking Available,691,1288.88,2702937.15
,,,1/29/2021,Deposit,4177,NA,NA,NA,ASC,1101.10 Cash:Saints JFX Oper. Acct. #2264:Checking Available,691,473.58,2703410.73
,,,1/29/2021,Deposit,4177,NA,NA,NA,ps-jk,1101.10 Cash:Saints JFX Oper. Acct. #2264:Checking Available,691,3595.6,2707006.33
,,,1/29/2021,Deposit,4177,NA,NA,NA,k-8,1101.10 Cash:Saints JFX Oper. Acct. #2264:Checking Available,691,33923.66,2740929.99
,,,2/1/2021,Journal Entry,11028,GC FEB 2021,NA,NA,NA,-Split-,NA,1020,2741949.99
,,,2/3/2021,Journal Entry,10583,MD 210203,NA,NA,Johnson girls (3),-Split-,NA,8582.35,2750532.34
,,,2/3/2021,Journal Entry,10583,MD 210203,NA,NA,NA,-Split-,NA,1945,2752477.34
,,,2/5/2021,Deposit,4466,NA,NA,NA,k-8,1101.10 Cash:Saints JFX Oper. Acct. #2264:Checking Available,691,11256.48,2763733.82
,,,2/5/2021,Deposit,4466,NA,NA,NA,ASC,1101.10 Cash:Saints JFX Oper. Acct. #2264:Checking Available,691,108,2763841.82
,,,2/5/2021,Deposit,4465,NA,NA,NA,ASC,1101.10 Cash:Saints JFX Oper. Acct. #2264:Checking Available,691,370,2764211.82
,,,2/5/2021,Deposit,4466,NA,NA,NA,ps-jk,1101.10 Cash:Saints JFX Oper. Acct. #2264:Checking Available,691,1149.96,2765361.78
,,,2/10/2021,Deposit,4454,NA,NA,NA,ps-jk,1101.10 Cash:Saints JFX Oper. Acct. #2264:Checking Available,691,5447.88,2770809.66
,,,2/10/2021,Deposit,4454,NA,NA,NA,k-8,1101.10 Cash:Saints JFX Oper. Acct. #2264:Checking Available,691,2372.19,2773181.85
,,,2/10/2021,Deposit,4454,NA,NA,NA,Extended Care,1101.10 Cash:Saints JFX Oper. Acct. #2264:Checking Available,691,383,2773564.85
,,,2/10/2021,Deposit,4456,NA,NA,NA,ps-jk,1101.10 Cash:Saints JFX Oper. Acct. #2264:Checking Available,691,10653.17,2784218.02
,,,2/10/2021,Deposit,4456,NA,NA,NA,k-8,1101.10 Cash:Saints JFX Oper. Acct. #2264:Checking Available,691,44651.56,2828869.58
,,,2/10/2021,Deposit,4456,NA,NA,NA,monthly school disc,1101.10 Cash:Saints JFX Oper. Acct. #2264:Checking Available,691,-556.74,2828312.84
,,,2/10/2021,Deposit,4456,NA,NA,NA,staff disc,1101.10 Cash:Saints JFX Oper. Acct. #2264:Checking Available,691,-1718.21,2826594.63
,,,2/10/2021,Deposit,4456,NA,NA,NA,scholarship,1101.10 Cash:Saints JFX Oper. Acct. #2264:Checking Available,691,-4200.65,2822393.98
,,,2/10/2021,Deposit,4456,NA,NA,NA,ASC,1101.10 Cash:Saints JFX Oper. Acct. #2264:Checking Available,691,467,2822860.98
,,,2/11/2021,Journal Entry,11024,md210211,NA,NA,NA,-Split-,NA,80,2822940.98
,,,2/12/2021,Deposit,4464,NA,NA,NA,ps-jk,1101.10 Cash:Saints JFX Oper. Acct. #2264:Checking Available,691,2900,2825840.98
,,,2/12/2021,Deposit,4467,NA,NA,NA,ASC,1101.10 Cash:Saints JFX Oper. Acct. #2264:Checking Available,691,194,2826034.98
,,,2/12/2021,Deposit,4467,NA,NA,NA,scholarship,1101.10 Cash:Saints JFX Oper. Acct. #2264:Checking Available,691,-891.38,2825143.6
,,,2/12/2021,Deposit,4467,NA,NA,NA,k-8,1101.10 Cash:Saints JFX Oper. Acct. #2264:Checking Available,691,5782.26,2830925.86
,,,2/19/2021,Deposit,4457,NA,NA,NA,ps-jk,1101.10 Cash:Saints JFX Oper. Acct. #2264:Checking Available,691,1257.53,2832183.39
,,,2/19/2021,Deposit,4457,NA,NA,NA,k-8,1101.10 Cash:Saints JFX Oper. Acct. #2264:Checking Available,691,11642.2,2843825.59
,,,2/19/2021,Deposit,4457,NA,NA,NA,staff disc,1101.10 Cash:Saints JFX Oper. Acct. #2264:Checking Available,691,-307.95,2843517.64
,,,2/19/2021,Deposit,4458,NA,NA,NA,k-8,1101.10 Cash:Saints JFX Oper. Acct. #2264:Checking Available,691,3022.28,2846539.92
,,,2/19/2021,Deposit,4458,NA,NA,NA,extended care,1101.10 Cash:Saints JFX Oper. Acct. #2264:Checking Available,691,156,2846695.92
,,,2/25/2021,Deposit,4459,NA,NA,NA,ASC,1101.10 Cash:Saints JFX Oper. Acct. #2264:Checking Available,691,157,2846852.92
,,,2/25/2021,Deposit,4459,NA,NA,NA,scholarship,1101.10 Cash:Saints JFX Oper. Acct. #2264:Checking Available,691,-4129.95,2842722.97
,,,2/25/2021,Deposit,4459,NA,NA,NA,staff disc,1101.10 Cash:Saints JFX Oper. Acct. #2264:Checking Available,691,-3830.45,2838892.52
,,,2/25/2021,Deposit,4459,NA,NA,NA,k-8,1101.10 Cash:Saints JFX Oper. Acct. #2264:Checking Available,691,139579.43,2978471.95
,,,2/25/2021,Deposit,4459,NA,NA,NA,ps-jk,1101.10 Cash:Saints JFX Oper. Acct. #2264:Checking Available,691,18518.94,2996990.89
,,,2/25/2021,Deposit,4460,NA,NA,NA,ps extended day,1101.10 Cash:Saints JFX Oper. Acct. #2264:Checking Available,691,397,2997387.89
,,,2/25/2021,Deposit,4460,NA,NA,NA,ps-jk,1101.10 Cash:Saints JFX Oper. Acct. #2264:Checking Available,691,12836.61,3010224.5
,,,2/25/2021,Deposit,4460,NA,NA,NA,k-8,1101.10 Cash:Saints JFX Oper. Acct. #2264:Checking Available,691,1665.06,3011889.56
,,,2/25/2021,Deposit,4460,NA,NA,NA,payment reallocation,1101.10 Cash:Saints JFX Oper. Acct. #2264:Checking Available,691,-182.3,3011707.26
,,,2/25/2021,Deposit,4460,NA,NA,NA,scholarship,1101.10 Cash:Saints JFX Oper. Acct. #2264:Checking Available,691,-429.44,3011277.82
,,,2/25/2021,Deposit,4460,NA,NA,NA,payment reallocation,1101.10 Cash:Saints JFX Oper. Acct. #2264:Checking Available,691,182.3,3011460.12
,,,2/26/2021,Deposit,4462,NA,NA,NA,ASC,1101.10 Cash:Saints JFX Oper. Acct. #2264:Checking Available,691,103,3011563.12
,,,2/26/2021,Deposit,4462,NA,NA,NA,scholarship,1101.10 Cash:Saints JFX Oper. Acct. #2264:Checking Available,691,-300,3011263.12
,,,2/26/2021,Deposit,4462,NA,NA,NA,staff disc,1101.10 Cash:Saints JFX Oper. Acct. #2264:Checking Available,691,-352.6,3010910.52
,,,2/26/2021,Deposit,4462,NA,NA,NA,k-8,1101.10 Cash:Saints JFX Oper. Acct. #2264:Checking Available,691,1410.8,3012321.32
,,,2/26/2021,Deposit,4462,NA,NA,NA,ps-jk,1101.10 Cash:Saints JFX Oper. Acct. #2264:Checking Available,691,535.66,3012856.98
,,,2/26/2021,Deposit,4461,NA,NA,NA,k-8,1101.10 Cash:Saints JFX Oper. Acct. #2264:Checking Available,691,-491.66,3012365.32
,,,2/26/2021,Deposit,4461,NA,NA,NA,ps-jk,1101.10 Cash:Saints JFX Oper. Acct. #2264:Checking Available,691,1660.73,3014026.05
,,,2/28/2021,Journal Entry,10802,SUN210228,NA,NA,NA,-Split-,NA,255,3014281.05
3102 Tuition - Prior,648,,,,,,,,,,,,
,,30883,,,,,,,,,,,
3110 Fees,29,,,,,,,,,,,,
3111 Registration Fee,NA,,,,,,,,,,,,
,,24170,,,,,,,,,,,
,,,1/1/2021,Journal Entry,10581,GC 210101,NA,NA,NA,-Split-,NA,67200,91370
,,,1/22/2021,Journal Entry,10577,MD 210122,NA,NA,Cook,-Split-,NA,350,91720
,,,1/24/2021,Journal Entry,10578,SUN 210124,NA,NA,NA,-Split-,NA,310,92030
,,,2/1/2021,Journal Entry,11028,GC FEB 2021,NA,NA,NA,-Split-,NA,46550,138580
,,,2/3/2021,Journal Entry,10583,MD 210203,NA,NA,NA,-Split-,NA,350,138930
,,,2/19/2021,Journal Entry,11025,MD210219,NA,NA,NA,-Split-,NA,700,139630
3112 Health/Other Insurance Fees,284,,,,,,,,,,,,
,,1512,,,,,,,,,,,
3113 Book & Supply Fees,30,,,,,,,,,,,,
,,210010.87,,,,,,,,,,,
,,,1/1/2021,Deposit,4352,NA,NA,NA,ps book,1101.10 Cash:Saints JFX Oper. Acct. #2264:Checking Available,691,25,210035.87
,,,1/5/2021,Deposit,4167,NA,NA,NA,book,1101.10 Cash:Saints JFX Oper. Acct. #2264:Checking Available,691,128,210163.87
,,,1/5/2021,Deposit,4167,NA,NA,NA,tech,1101.10 Cash:Saints JFX Oper. Acct. #2264:Checking Available,691,148.88,210312.75
,,,1/5/2021,Deposit,4173,NA,NA,NA,book,1101.10 Cash:Saints JFX Oper. Acct. #2264:Checking Available,691,35.56,210348.31
,,,1/5/2021,Deposit,4173,NA,NA,NA,tech,1101.10 Cash:Saints JFX Oper. Acct. #2264:Checking Available,691,38.89,210387.2
,,,1/8/2021,Deposit,4168,NA,NA,NA,ps book,1101.10 Cash:Saints JFX Oper. Acct. #2264:Checking Available,691,10,210397.2
,,,1/8/2021,Deposit,4168,NA,NA,NA,tech,1101.10 Cash:Saints JFX Oper. Acct. #2264:Checking Available,691,530,210927.2
,,,1/8/2021,Deposit,4168,NA,NA,NA,book,1101.10 Cash:Saints JFX Oper. Acct. #2264:Checking Available,691,376.45,211303.65
,,,1/15/2021,Deposit,4169,NA,NA,NA,ps book,1101.10 Cash:Saints JFX Oper. Acct. #2264:Checking Available,691,50,211353.65
,,,1/15/2021,Deposit,4169,NA,NA,NA,tech,1101.10 Cash:Saints JFX Oper. Acct. #2264:Checking Available,691,5324.5,216678.15
,,,1/15/2021,Deposit,4169,NA,NA,NA,book,1101.10 Cash:Saints JFX Oper. Acct. #2264:Checking Available,691,4473.54,221151.69
,,,1/15/2021,Deposit,4169,NA,NA,NA,EDU kits,1101.10 Cash:Saints JFX Oper. Acct. #2264:Checking Available,691,34.65,221186.34
,,,1/15/2021,Deposit,4174,NA,NA,NA,tech,1101.10 Cash:Saints JFX Oper. Acct. #2264:Checking Available,691,793.33,221979.67
,,,1/15/2021,Deposit,4174,NA,NA,NA,book,1101.10 Cash:Saints JFX Oper. Acct. #2264:Checking Available,691,907.49,222887.16
,,,1/18/2021,Journal Entry,10576,MD 210118,NA,NA,NA,-Split-,NA,320,223207.16
,,,1/18/2021,Journal Entry,10576,MD 210118,NA,NA,Tech fee,-Split-,NA,350,223557.16
,,,1/20/2021,Deposit,4170,NA,NA,NA,ps book,1101.10 Cash:Saints JFX Oper. Acct. #2264:Checking Available,691,45,223602.16
,,,1/20/2021,Deposit,4170,NA,NA,NA,tech,1101.10 Cash:Saints JFX Oper. Acct. #2264:Checking Available,691,1875,225477.16
,,,1/20/2021,Deposit,4170,NA,NA,NA,book,1101.10 Cash:Saints JFX Oper. Acct. #2264:Checking Available,691,1529,227006.16
,,,1/20/2021,Deposit,4175,NA,NA,NA,ps book,1101.10 Cash:Saints JFX Oper. Acct. #2264:Checking Available,691,25,227031.16
,,,1/20/2021,Deposit,4170,NA,NA,NA,EDU kits,1101.10 Cash:Saints JFX Oper. Acct. #2264:Checking Available,691,27.38,227058.54
,,,1/25/2021,Deposit,4171,NA,NA,NA,tech,1101.10 Cash:Saints JFX Oper. Acct. #2264:Checking Available,691,13300.91,240359.45
,,,1/25/2021,Deposit,4176,NA,NA,NA,book,1101.10 Cash:Saints JFX Oper. Acct. #2264:Checking Available,691,282.23,240641.68
,,,1/25/2021,Deposit,4176,NA,NA,NA,tech,1101.10 Cash:Saints JFX Oper. Acct. #2264:Checking Available,691,209.03,240850.71
,,,1/25/2021,Deposit,4171,NA,NA,NA,book,1101.10 Cash:Saints JFX Oper. Acct. #2264:Checking Available,691,10480.27,251330.98
,,,1/25/2021,Deposit,4171,NA,NA,NA,EDU kits,1101.10 Cash:Saints JFX Oper. Acct. #2264:Checking Available,691,62.46,251393.44
,,,1/25/2021,Deposit,4171,NA,NA,NA,ps book,1101.10 Cash:Saints JFX Oper. Acct. #2264:Checking Available,691,170,251563.44
,,,1/25/2021,Deposit,4171,NA,NA,NA,NA,1101.10 Cash:Saints JFX Oper. Acct. #2264:Checking Available,691,1427,252990.44
,,,1/25/2021,Deposit,4176,NA,NA,NA,payment reallocation fee,1101.10 Cash:Saints JFX Oper. Acct. #2264:Checking Available,691,182.3,253172.74
,,,1/29/2021,Deposit,4177,NA,NA,NA,ps book,1101.10 Cash:Saints JFX Oper. Acct. #2264:Checking Available,691,30.56,253203.3
,,,1/29/2021,Deposit,4177,NA,NA,NA,tech,1101.10 Cash:Saints JFX Oper. Acct. #2264:Checking Available,691,2018,255221.3
,,,1/29/2021,Deposit,4177,NA,NA,NA,book,1101.10 Cash:Saints JFX Oper. Acct. #2264:Checking Available,691,1815.55,257036.85
,,,1/29/2021,Deposit,4178,NA,NA,NA,book,1101.10 Cash:Saints JFX Oper. Acct. #2264:Checking Available,691,16.66,257053.51
,,,2/3/2021,Journal Entry,10583,MD 210203,NA,NA,Johnson girls (3),-Split-,NA,630,257683.51
,,,2/3/2021,Journal Entry,10583,MD 210203,NA,NA,directories,-Split-,NA,175,257858.51
,,,2/3/2021,Journal Entry,10583,MD 210203,NA,NA,Johnson girls (3),-Split-,NA,576,258434.51
,,,2/5/2021,Deposit,4466,NA,NA,NA,tech,1101.10 Cash:Saints JFX Oper. Acct. #2264:Checking Available,691,714.03,259148.54
,,,2/5/2021,Deposit,4466,NA,NA,NA,ps book,1101.10 Cash:Saints JFX Oper. Acct. #2264:Checking Available,691,5,259153.54
,,,2/5/2021,Deposit,4466,NA,NA,NA,book,1101.10 Cash:Saints JFX Oper. Acct. #2264:Checking Available,691,625.56,259779.1
,,,2/10/2021,Deposit,4454,NA,NA,NA,ps book,1101.10 Cash:Saints JFX Oper. Acct. #2264:Checking Available,691,124.78,259903.88
,,,2/10/2021,Deposit,4454,NA,NA,NA,tech,1101.10 Cash:Saints JFX Oper. Acct. #2264:Checking Available,691,93.33,259997.21
,,,2/10/2021,Deposit,4456,NA,NA,NA,tech,1101.10 Cash:Saints JFX Oper. Acct. #2264:Checking Available,691,2713.01,262710.22
,,,2/10/2021,Deposit,4456,NA,NA,NA,book,1101.10 Cash:Saints JFX Oper. Acct. #2264:Checking Available,691,2320.41,265030.63
,,,2/10/2021,Deposit,4456,NA,NA,NA,ps book,1101.10 Cash:Saints JFX Oper. Acct. #2264:Checking Available,691,45,265075.63
,,,2/11/2021,Journal Entry,10796,SCH210211,NA,NA,tech fee,-Split-,NA,50,265125.63
,,,2/12/2021,Deposit,4467,NA,NA,NA,tech,1101.10 Cash:Saints JFX Oper. Acct. #2264:Checking Available,691,451.25,265576.88
,,,2/12/2021,Deposit,4467,NA,NA,NA,book,1101.10 Cash:Saints JFX Oper. Acct. #2264:Checking Available,691,344,265920.88
,,,2/12/2021,Deposit,4464,NA,NA,NA,ps book,1101.10 Cash:Saints JFX Oper. Acct. #2264:Checking Available,691,25,265945.88
,,,2/19/2021,Deposit,4457,NA,NA,NA,ps book,1101.10 Cash:Saints JFX Oper. Acct. #2264:Checking Available,691,10,265955.88
,,,2/19/2021,Deposit,4458,NA,NA,NA,tech,1101.10 Cash:Saints JFX Oper. Acct. #2264:Checking Available,691,150,266105.88
,,,2/19/2021,Deposit,4457,NA,NA,NA,tech,1101.10 Cash:Saints JFX Oper. Acct. #2264:Checking Available,691,647.42,266753.3
,,,2/19/2021,Deposit,4458,NA,NA,NA,book,1101.10 Cash:Saints JFX Oper. Acct. #2264:Checking Available,691,137.16,266890.46
,,,2/19/2021,Deposit,4457,NA,NA,NA,book,1101.10 Cash:Saints JFX Oper. Acct. #2264:Checking Available,691,581.21,267471.67
,,,2/25/2021,Deposit,4460,NA,NA,NA,book,1101.10 Cash:Saints JFX Oper. Acct. #2264:Checking Available,691,159.53,267631.2
,,,2/25/2021,Deposit,4460,NA,NA,NA,tech,1101.10 Cash:Saints JFX Oper. Acct. #2264:Checking Available,691,82.64,267713.84
,,,2/25/2021,Deposit,4459,NA,NA,NA,refund,1101.10 Cash:Saints JFX Oper. Acct. #2264:Checking Available,691,1427,269140.84
,,,2/25/2021,Deposit,4459,NA,NA,NA,book,1101.10 Cash:Saints JFX Oper. Acct. #2264:Checking Available,691,7264.89,276405.73
,,,2/25/2021,Deposit,4459,NA,NA,NA,tech,1101.10 Cash:Saints JFX Oper. Acct. #2264:Checking Available,691,8917.79,285323.52
,,,2/25/2021,Deposit,4459,NA,NA,NA,ps book,1101.10 Cash:Saints JFX Oper. Acct. #2264:Checking Available,691,107.23,285430.75
,,,2/26/2021,Deposit,4462,NA,NA,NA,book,1101.10 Cash:Saints JFX Oper. Acct. #2264:Checking Available,691,64,285494.75
,,,2/26/2021,Deposit,4462,NA,NA,NA,ps book,1101.10 Cash:Saints JFX Oper. Acct. #2264:Checking Available,691,5,285499.75
,,,2/26/2021,Deposit,4461,NA,NA,NA,book,1101.10 Cash:Saints JFX Oper. Acct. #2264:Checking Available,691,24.99,285524.74
,,,2/26/2021,Deposit,4462,NA,NA,NA,tech,1101.10 Cash:Saints JFX Oper. Acct. #2264:Checking Available,691,70,285594.74
3115 Activity/Program Fees,285,,,,,,,,,,,,
,,13440.78,,,,,,,,,,,
,,,1/1/2021,Journal Entry,10581,GC 210101,NA,NA,NA,-Split-,NA,850,14290.78
,,,1/15/2021,Deposit,4169,NA,NA,NA,athletics,1101.10 Cash:Saints JFX Oper. Acct. #2264:Checking Available,691,150,14440.78
,,,1/25/2021,Deposit,4171,NA,NA,NA,athletics fee,1101.10 Cash:Saints JFX Oper. Acct. #2264:Checking Available,691,690,15130.78
,,,1/29/2021,Deposit,4177,NA,NA,NA,athletic fee,1101.10 Cash:Saints JFX Oper. Acct. #2264:Checking Available,691,15,15145.78
,,,1/31/2021,Journal Entry,10582,SUNC 210131,NA,NA,NA,-Split-,NA,200,15345.78
,,,2/1/2021,Journal Entry,11028,GC FEB 2021,NA,NA,NA,-Split-,NA,1000,16345.78
,,,2/3/2021,Journal Entry,10583,MD 210203,NA,NA,NA,-Split-,NA,2400,18745.78
,,,2/3/2021,Journal Entry,10583,MD 210203,NA,NA,ACTION funds transfer (ask joe),-Split-,NA,6500,25245.78
,,,2/5/2021,Deposit,4466,NA,NA,NA,NA,1101.10 Cash:Saints JFX Oper. Acct. #2264:Checking Available,691,35,25280.78
,,,2/19/2021,Deposit,4457,NA,NA,NA,Athletics,1101.10 Cash:Saints JFX Oper. Acct. #2264:Checking Available,691,35,25315.78
,,,2/24/2021,Journal Entry,11027,MD210224,NA,NA,NA,-Split-,NA,80,25395.78
3116 Athletic Fee,31,,,,,,,,,,,,
,,1290,,,,,,,,,,,
3117 Graduation Fee,33,,,,,,,,,,,,
,,,2/22/2021,Bill,8556,AF00033940,Catholic Bishop of Chicago (BillingSFXS),548,NA,2000 Accounts Payable,217,-297,-297
3120 Sacramental Fee,35,,,,,,,,,,,,
,,635,,,,,,,,,,,
3125 3rd Party Fees,419,,,,,,,,,,,,
,,13212.9,,,,,,,,,,,
,,,1/1/2021,Deposit,4352,NA,NA,NA,late,1101.10 Cash:Saints JFX Oper. Acct. #2264:Checking Available,691,40,13252.9
,,,1/5/2021,Deposit,4167,NA,NA,NA,disp,1101.10 Cash:Saints JFX Oper. Acct. #2264:Checking Available,691,36,13288.9
,,,1/5/2021,Deposit,4167,NA,NA,NA,late,1101.10 Cash:Saints JFX Oper. Acct. #2264:Checking Available,691,280,13568.9
,,,1/8/2021,Deposit,4168,NA,NA,NA,late,1101.10 Cash:Saints JFX Oper. Acct. #2264:Checking Available,691,40,13608.9
,,,1/15/2021,Deposit,4174,NA,NA,NA,late,1101.10 Cash:Saints JFX Oper. Acct. #2264:Checking Available,691,80,13688.9
,,,1/15/2021,Deposit,4169,NA,NA,NA,late,1101.10 Cash:Saints JFX Oper. Acct. #2264:Checking Available,691,480,14168.9
,,,1/25/2021,Deposit,4171,NA,NA,NA,over payment,1101.10 Cash:Saints JFX Oper. Acct. #2264:Checking Available,691,80,14248.9
,,,1/25/2021,Deposit,4171,NA,NA,NA,late,1101.10 Cash:Saints JFX Oper. Acct. #2264:Checking Available,691,240,14488.9
,,,1/29/2021,Deposit,4178,NA,NA,NA,late,1101.10 Cash:Saints JFX Oper. Acct. #2264:Checking Available,691,40,14528.9
,,,1/29/2021,Deposit,4178,NA,NA,NA,disp,1101.10 Cash:Saints JFX Oper. Acct. #2264:Checking Available,691,36,14564.9
,,,1/29/2021,Deposit,4177,NA,NA,NA,late,1101.10 Cash:Saints JFX Oper. Acct. #2264:Checking Available,691,240,14804.9
,,,2/5/2021,Deposit,4466,NA,NA,NA,smart bank,1101.10 Cash:Saints JFX Oper. Acct. #2264:Checking Available,691,60,14864.9
,,,2/5/2021,Deposit,4466,NA,NA,NA,late,1101.10 Cash:Saints JFX Oper. Acct. #2264:Checking Available,691,160,15024.9
,,,2/10/2021,Deposit,4456,NA,NA,NA,late,1101.10 Cash:Saints JFX Oper. Acct. #2264:Checking Available,691,360,15384.9
,,,2/10/2021,Deposit,4456,NA,NA,NA,disp,1101.10 Cash:Saints JFX Oper. Acct. #2264:Checking Available,691,72,15456.9
,,,2/12/2021,Deposit,4464,NA,NA,NA,disp,1101.10 Cash:Saints JFX Oper. Acct. #2264:Checking Available,691,36,15492.9
,,,2/12/2021,Deposit,4467,NA,NA,NA,late,1101.10 Cash:Saints JFX Oper. Acct. #2264:Checking Available,691,160,15652.9
,,,2/12/2021,Deposit,4464,NA,NA,NA,late,1101.10 Cash:Saints JFX Oper. Acct. #2264:Checking Available,691,40,15692.9
,,,2/19/2021,Deposit,4457,NA,NA,NA,late,1101.10 Cash:Saints JFX Oper. Acct. #2264:Checking Available,691,80,15772.9
,,,2/19/2021,Deposit,4457,NA,NA,NA,disp,1101.10 Cash:Saints JFX Oper. Acct. #2264:Checking Available,691,36,15808.9
,,,2/19/2021,Deposit,4458,NA,NA,NA,late,1101.10 Cash:Saints JFX Oper. Acct. #2264:Checking Available,691,40,15848.9
,,,2/25/2021,Deposit,4459,NA,NA,NA,late,1101.10 Cash:Saints JFX Oper. Acct. #2264:Checking Available,691,40,15888.9
,,,2/25/2021,Deposit,4459,NA,NA,NA,disp,1101.10 Cash:Saints JFX Oper. Acct. #2264:Checking Available,691,72,15960.9
3125A 3rd Party Rev.,658,,,,,,,,,,,,
,,216,,,,,,,,,,,
3125B 3rd Party Exp,612,,,,,,,,,,,,
,,5440,,,,,,,,,,,
3300 Food Services,37,,,,,,,,,,,,
3301 School Meal Program,NA,,,,,,,,,,,,
,,,1/1/2021,Journal Entry,10581,GC 210101,NA,NA,MIlk,-Split-,NA,104,104
,,,2/1/2021,Journal Entry,11028,GC FEB 2021,NA,NA,NA,-Split-,NA,130,234
,,,2/19/2021,Journal Entry,11025,MD210219,NA,NA,MILK,-Split-,NA,179,413
3350 Lease and/or Rental Income,595,,,,,,,,,,,,
3351 Facility Lease,NA,,,,,,,,,,,,
,,30500,,,,,,,,,,,
,,,1/3/2021,Journal Entry,10570,SUN 210103,NA,NA,Harnett,-Split-,NA,550,31050
,,,1/7/2021,Journal Entry,10586,210107 MD,NA,NA,NA,-Split-,NA,4500,35550
,,,2/3/2021,Journal Entry,10583,MD 210203,NA,NA,NA,-Split-,NA,4500,40050
,,,2/11/2021,Journal Entry,11024,md210211,NA,NA,HARNETT,-Split-,NA,550,40600
,,,2/19/2021,Journal Entry,11025,MD210219,NA,NA,PKG LOT RENTAL,-Split-,NA,800,41400
,,,2/28/2021,Journal Entry,10802,SUN210228,NA,NA,NA,-Split-,NA,4500,45900
3352 Facility Rental,630,,,,,,,,,,,,
,,150,,,,,,,,,,,
,,,2/3/2021,Journal Entry,10583,MD 210203,NA,NA,pkg lot rental,-Split-,NA,150,300
,,,2/9/2021,Bill,7180,RR pkg lot help,Jonathan Metzinger,438,2/14 concert - rental of parking lot,2000 Accounts Payable,217,-100,200
3400 Outside Funding Sources,358,,,,,,,,,,,,
3407 Other Scholarships,NA,,,,,,,,,,,,
3407.01 Tax Credit Scholarship,NA,,,,,,,,,,,,
,,65526.5,,,,,,,,,,,
3450 Fund Raising Net Income,678,,,,,,,,,,,,
3461 St. Joseph School Fundraising,NA,,,,,,,,,,,,
3461.03 SJS Annual Fund Drive,NA,,,,,,,,,,,,
,,670,,,,,,,,,,,
,,,1/1/2021,Journal Entry,10581,GC 210101,NA,NA,NA,-Split-,NA,30,700
,,,2/1/2021,Journal Entry,11028,GC FEB 2021,NA,NA,NA,-Split-,NA,45,745
,,,2/11/2021,Journal Entry,10796,SCH210211,NA,NA,NA,-Split-,NA,770,1515
3462 StFrancis Xavier Sch Fundraiser,650,,,,,,,,,,,,
3462.01 SFXS Annual School Appeal,NA,,,,,,,,,,,,
,,1000,,,,,,,,,,,
,,,2/11/2021,Journal Entry,10796,SCH210211,NA,NA,NA,-Split-,NA,1000,2000
3500 Interest & Investment Income,41,,,,,,,,,,,,
3501 Interest-Arch Regular Savings,NA,,,,,,,,,,,,
,,1646.24,,,,,,,,,,,
3502 Interest-Arch Cert of Deposit,42,,,,,,,,,,,,
,,671.46,,,,,,,,,,,
3503 Interest-Arch Building Fund,43,,,,,,,,,,,,
,,2146.75,,,,,,,,,,,
3504 Invest. Gains/Losses Arch Endow,44,,,,,,,,,,,,
,,548814.09,,,,,,,,,,,
3505 Invest. Gains/Loss Arch Spc Inv,147,,,,,,,,,,,,
,,23768.66,,,,,,,,,,,
3506 Interest-Checking Accounts,148,,,,,,,,,,,,
,,44.58,,,,,,,,,,,
,,,1/4/2021,Deposit,4447,NA,NA,NA,Interest,1107.01 Cash:Old St. Francis Xavier Accounts:St. Francis Xavier Ckg #0396,332,1.45,46.03
3507 Other Interest Account,45,,,,,,,,,,,,
,,211.92,,,,,,,,,,,
,,,1/31/2021,Deposit,4050,NA,NA,NA,Interest,1107.02 Cash:Old St. Francis Xavier Accounts:St Francis Xavier EGiving #0640,333,0.62,212.54
,,,2/28/2021,Deposit,4051,NA,NA,NA,Interest,1107.02 Cash:Old St. Francis Xavier Accounts:St Francis Xavier EGiving #0640,333,0.21,212.75
3600 Auxiliary Groups,460,,,,,,,,,,,,
3603 St Francis Xavier Auxiliary,NA,,,,,,,,,,,,
3603.02 SFX Men's Club,NA,,,,,,,,,,,,
,,23300.38,,,,,,,,,,,
3603.10 SFXS Home School Organization,464,,,,,,,,,,,,
,,61270,,,,,,,,,,,
3700 Miscellaneous Income,263,,,,,,,,,,,,
3701 Stole Fees,NA,,,,,,,,,,,,
3701.10 Baptism,NA,,,,,,,,,,,,
,,1810,,,,,,,,,,,
,,,2/3/2021,Journal Entry,10583,MD 210203,NA,NA,NA,-Split-,NA,500,2310
3701.20 Funeral,508,,,,,,,,,,,,
,,13625,,,,,,,,,,,
,,,1/10/2021,Journal Entry,10572,SPEC 210110,NA,NA,NA,-Split-,NA,300,13925
,,,1/18/2021,Journal Entry,10576,MD 210118,NA,NA,NA,-Split-,NA,300,14225
,,,1/22/2021,Journal Entry,10577,MD 210122,NA,NA,NA,-Split-,NA,600,14825
,,,2/3/2021,Journal Entry,10583,MD 210203,NA,NA,NA,-Split-,NA,300,15125
,,,2/23/2021,Journal Entry,11026,MD210223,NA,NA,NA,-Split-,NA,1100,16225
,,,2/24/2021,Journal Entry,11027,MD210224,NA,NA,NA,-Split-,NA,300,16525
,,,2/28/2021,Journal Entry,10802,SUN210228,NA,NA,NA,-Split-,NA,550,17075
3701.30 Wedding,509,,,,,,,,,,,,
,,13055,,,,,,,,,,,
,,,1/3/2021,Journal Entry,10570,SUN 210103,NA,NA,NA,-Split-,NA,600,13655
,,,2/3/2021,Journal Entry,10583,MD 210203,NA,NA,NA,-Split-,NA,200,13855
,,,2/28/2021,Journal Entry,10802,SUN210228,NA,NA,NA,-Split-,NA,500,14355
3702 Stipend for Masses,156,,,,,,,,,,,,
,,9155,,,,,,,,,,,
,,,1/1/2021,Journal Entry,10581,GC 210101,NA,NA,mass card,-Split-,NA,100,9255
,,,1/3/2021,Journal Entry,10570,SUN 210103,NA,NA,NA,-Split-,NA,90,9345
,,,1/7/2021,Journal Entry,10586,210107 MD,NA,NA,NA,-Split-,NA,465,9810
,,,1/10/2021,Journal Entry,10572,SPEC 210110,NA,NA,NA,-Split-,NA,65,9875
,,,1/18/2021,Journal Entry,10576,MD 210118,NA,NA,NA,-Split-,NA,260,10135
,,,1/24/2021,Journal Entry,10578,SUN 210124,NA,NA,NA,-Split-,NA,460,10595
,,,1/31/2021,Journal Entry,10582,SUNC 210131,NA,NA,NA,-Split-,NA,670,11265
,,,2/1/2021,Journal Entry,11028,GC FEB 2021,NA,NA,NA,-Split-,NA,20,11285
,,,2/3/2021,Journal Entry,10583,MD 210203,NA,NA,NA,-Split-,NA,100,11385
,,,2/11/2021,Journal Entry,11024,md210211,NA,NA,NA,-Split-,NA,250,11635
,,,2/14/2021,Journal Entry,10799,SUN210214,NA,NA,NA,-Split-,NA,10,11645
3703 Votive and Vigil Candles,157,,,,,,,,,,,,
,,1886.62,,,,,,,,,,,
,,,1/27/2021,Deposit,4440,NA,NA,NA,NA,1101.10 Cash:Saints JFX Oper. Acct. #2264:Checking Available,691,514.68,2401.3
,,,2/11/2021,Journal Entry,11024,md210211,NA,NA,NA,-Split-,NA,91,2492.3
,,,2/23/2021,Journal Entry,11026,MD210223,NA,NA,NA,-Split-,NA,25,2517.3
3705 Scholarship Income,634,,,,,,,,,,,,
,,328,,,,,,,,,,,
,,,2/11/2021,Journal Entry,10796,SCH210211,NA,NA,NA,-Split-,NA,200,528
3706 Donations,159,,,,,,,,,,,,
,,17996.71,,,,,,,,,,,
,,,1/1/2021,Journal Entry,10581,GC 210101,NA,NA,SFXS support,-Split-,NA,100,18096.71
,,,1/21/2021,Deposit,4165,NA,NA,NA,NA,1240.03 Oper. Savings at the Arch Bank:Stock Savings Account:StJoseph Stk/Mut Fnd #402440250,609,1826.05,19922.76
,,,1/31/2021,Journal Entry,10582,SUNC 210131,NA,NA,NA,-Split-,NA,10000,29922.76
,,,2/3/2021,Journal Entry,10583,MD 210203,NA,NA,memorial donation PJP,-Split-,NA,250,30172.76
,,,2/7/2021,Journal Entry,10783,SUN 210207,NA,NA,NA,-Split-,NA,100,30272.76
,,,2/11/2021,Journal Entry,10796,SCH210211,NA,NA,NA,-Split-,NA,9675,39947.76
,,,2/16/2021,Deposit,4468,NA,NA,NA,United Way,1101.10 Cash:Saints JFX Oper. Acct. #2264:Checking Available,691,159.95,40107.71
,,,2/19/2021,Journal Entry,11025,MD210219,NA,NA,NA,-Split-,NA,543,40650.71
,,,2/23/2021,Journal Entry,11026,MD210223,NA,NA,csw,-Split-,NA,1000,41650.71
,,,2/28/2021,Journal Entry,10802,SUN210228,NA,NA,NA,-Split-,NA,3000,44650.71
3720 Other Miscellaneous Income,312,,,,,,,,,,,,
,,90359.61,,,,,,,,,,,
,,,1/3/2021,Journal Entry,10570,SUN 210103,NA,NA,Union Pacific,-Split-,NA,164.9,90524.51
,,,1/10/2021,Journal Entry,10572,SPEC 210110,NA,NA,Teacher gift $$,-Split-,NA,275,90799.51
,,,1/22/2021,Deposit,4163,NA,NA,NA,MOC collection,1101.10 Cash:Saints JFX Oper. Acct. #2264:Checking Available,691,495,91294.51
,,,2/1/2021,Journal Entry,11028,GC FEB 2021,NA,NA,mens club FB squares,-Split-,NA,12900,104194.51
4010 Salaries,638,,,,,,,,,,,,
4011 Priests,NA,,,,,,,,,,,,
,,74003.68,,,,,,,,,,,
,,,1/8/2021,Journal Entry,10563,PP01082021,NA,NA,Priests,-Split-,NA,3416.65,77420.33
,,,1/8/2021,Journal Entry,10565,PP01082021,NA,NA,Priests,-Split-,NA,738.5,78158.83
,,,1/11/2021,Bill,6579,RR Rodlin wages,St. Joan of Arc,870,gross wages from last two wks at SSJFX,2000 Accounts Payable,217,1263.58,79422.41
,,,1/22/2021,Journal Entry,10564,PP01222021,NA,NA,Priests,-Split-,NA,3416.65,82839.06
,,,1/22/2021,Journal Entry,10567,PP01222021,NA,NA,NA,-Split-,NA,414,83253.06
,,,1/22/2021,Journal Entry,10567,PP01222021,NA,NA,Priests,-Split-,NA,138.5,83391.56
,,,2/5/2021,Journal Entry,10589,PP02192022,NA,NA,Priests,-Split-,NA,438.5,83830.06
,,,2/5/2021,Journal Entry,10587,PP02052021,NA,NA,Priests,-Split-,NA,3416.65,87246.71
,,,2/5/2021,Journal Entry,10589,PP02192022,NA,NA,NA,-Split-,NA,513.5,87760.21
,,,2/19/2021,Journal Entry,10590,PP02192021,NA,NA,NA,-Split-,NA,138.5,87898.71
,,,2/19/2021,Journal Entry,10588,PP02192021,NA,NA,Priests,-Split-,NA,3416.65,91315.36
,,,2/19/2021,Journal Entry,10590,PP02192021,NA,NA,Priests,-Split-,NA,138.5,91453.86
,,,3/5/2021,Journal Entry,11030,PP20210305,NA,NA,Priests,-Split-,NA,3416.65,94870.51
,,,3/5/2021,Journal Entry,11029,PP20210305,NA,NA,NA,-Split-,NA,363.5,95234.01
,,,3/5/2021,Journal Entry,11029,PP20210305,NA,NA,Priests,-Split-,NA,438.5,95672.51
4012 Extra Priests,576,,,,,,,,,,,,
,,1445,,,,,,,,,,,
,,,1/8/2021,Journal Entry,10565,PP01082021,NA,NA,Priests,-Split-,NA,738.5,2183.5
,,,2/9/2021,Bill,7176,McGrath Jan masses,Canisius House Jesuit Community,450,NA,2000 Accounts Payable,217,85,2268.5
,,,2/9/2021,Bill,7182,Chun Jan masses,Jesuit Community of Loyola University,360,NA,2000 Accounts Payable,217,255,2523.5
,,,2/23/2021,Bill,8540,Action Mass 2/28,Leo Agustina,373,NA,2000 Accounts Payable,217,100,2623.5
,,,2/23/2021,Bill,8548,help w 1st Recon,Rich Jakubik,374,NA,2000 Accounts Payable,217,75,2698.5
,,,3/10/2021,Bill,8645,Feb Mass stipend,Canisius House Jesuit Community,450,NA,2000 Accounts Payable,217,100,2798.5
,,,3/10/2021,Bill,8646,Feb Mass stipend,Jesuit Community of Loyola University,360,NA,2000 Accounts Payable,217,200,2998.5
4014 Professional Staff,672,,,,,,,,,,,,
,,194449.29,,,,,,,,,,,
,,,1/8/2021,Journal Entry,10563,PP01082021,NA,NA,GTL,-Split-,NA,-3.02,194446.27
,,,1/8/2021,Journal Entry,10563,PP01082021,NA,NA,Admin Staff,-Split-,NA,4257.08,198703.35
,,,1/8/2021,Journal Entry,10563,PP01082021,NA,NA,GTL,-Split-,NA,-2.64,198700.71
,,,1/8/2021,Journal Entry,10563,PP01082021,NA,NA,RE,-Split-,NA,1851.85,200552.56
,,,1/8/2021,Journal Entry,10563,PP01082021,NA,NA,Music Staff,-Split-,NA,3756.54,204309.1
,,,1/8/2021,Journal Entry,10565,PP01082021,NA,NA,GTL,-Split-,NA,0,204309.1
,,,1/8/2021,Journal Entry,10565,PP01082021,NA,NA,Admin Staff,-Split-,NA,1287.5,205596.6
,,,1/8/2021,Journal Entry,10565,PP01082021,NA,NA,RE,-Split-,NA,2706,208302.6
,,,1/22/2021,Journal Entry,10567,PP01222021,NA,NA,RE,-Split-,NA,2706,211008.6
,,,1/22/2021,Journal Entry,10567,PP01222021,NA,NA,Admin Staff,-Split-,NA,1287.5,212296.1
,,,1/22/2021,Journal Entry,10564,PP01222021,NA,NA,GTL,-Split-,NA,-2.64,212293.46
,,,1/22/2021,Journal Entry,10564,PP01222021,NA,NA,RE,-Split-,NA,1851.85,214145.31
,,,1/22/2021,Journal Entry,10564,PP01222021,NA,NA,Music Staff,-Split-,NA,4206.54,218351.85
,,,1/22/2021,Journal Entry,10564,PP01222021,NA,NA,GTL,-Split-,NA,-3.02,218348.83
,,,1/22/2021,Journal Entry,10564,PP01222021,NA,NA,Admin Staff,-Split-,NA,4257.08,222605.91
,,,2/5/2021,Journal Entry,10587,PP02052021,NA,NA,Music Staff,-Split-,NA,3481.54,226087.45
,,,2/5/2021,Journal Entry,10587,PP02052021,NA,NA,RE,-Split-,NA,1851.85,227939.3
,,,2/5/2021,Journal Entry,10589,PP02192022,NA,NA,RE,-Split-,NA,2706,230645.3
,,,2/5/2021,Journal Entry,10587,PP02052021,NA,NA,GTL,-Split-,NA,-3.02,230642.28
,,,2/5/2021,Journal Entry,10587,PP02052021,NA,NA,Admin Staff,-Split-,NA,4257.08,234899.36
,,,2/5/2021,Journal Entry,10589,PP02192022,NA,NA,Admin Staff,-Split-,NA,1287.5,236186.86
,,,2/5/2021,Journal Entry,10587,PP02052021,NA,NA,Manual Check #3952,-Split-,NA,-196.31,235990.55
,,,2/5/2021,Journal Entry,10587,PP02052021,NA,NA,GTL,-Split-,NA,-2.64,235987.91
,,,2/19/2021,Journal Entry,10590,PP02192021,NA,NA,Admin Staff,-Split-,NA,1287.5,237275.41
,,,2/19/2021,Journal Entry,10590,PP02192021,NA,NA,RE,-Split-,NA,2706,239981.41
,,,2/19/2021,Journal Entry,10588,PP02192021,NA,NA,GTL,-Split-,NA,-2.64,239978.77
,,,2/19/2021,Journal Entry,10588,PP02192021,NA,NA,RE,-Split-,NA,1851.85,241830.62
,,,2/19/2021,Journal Entry,10588,PP02192021,NA,NA,Music Staff,-Split-,NA,2830.77,244661.39
,,,2/19/2021,Journal Entry,10588,PP02192021,NA,NA,GTL,-Split-,NA,-3.02,244658.37
,,,2/19/2021,Journal Entry,10588,PP02192021,NA,NA,Admin Staff,-Split-,NA,4257.08,248915.45
,,,2/28/2021,Journal Entry,10802,SUN210228,NA,NA,brown maternity leave,-Split-,NA,-7725,241190.45
,,,3/5/2021,Journal Entry,11030,PP20210305,NA,NA,RE,-Split-,NA,1851.85,243042.3
,,,3/5/2021,Journal Entry,11029,PP20210305,NA,NA,Admin Staff,-Split-,NA,1287.5,244329.8
,,,3/5/2021,Journal Entry,11030,PP20210305,NA,NA,Music Staff,-Split-,NA,3155.77,247485.57
,,,3/5/2021,Journal Entry,11030,PP20210305,NA,NA,GTL,-Split-,NA,-3.02,247482.55
,,,3/5/2021,Journal Entry,11030,PP20210305,NA,NA,Admin Staff,-Split-,NA,4257.08,251739.63
,,,3/5/2021,Journal Entry,11030,PP20210305,NA,NA,GTL,-Split-,NA,-2.64,251736.99
,,,3/5/2021,Journal Entry,11029,PP20210305,NA,NA,RE,-Split-,NA,2706,254442.99
4015 Admin Support Staff - Church,397,,,,,,,,,,,,
,,191100.31,,,,,,,,,,,
,,,1/8/2021,Journal Entry,10565,PP01082021,NA,NA,Receptionist,-Split-,NA,0,191100.31
,,,1/8/2021,Journal Entry,10565,PP01082021,NA,NA,GTL,-Split-,NA,0,191100.31
,,,1/8/2021,Journal Entry,10565,PP01082021,NA,NA,Support Staff,-Split-,NA,2223.08,193323.39
,,,1/8/2021,Journal Entry,10565,PP01082021,NA,NA,Support Staff,-Split-,NA,3786.56,197109.95
,,,1/8/2021,Journal Entry,10565,PP01082021,NA,NA,GTL,-Split-,NA,-0.85,197109.1
,,,1/8/2021,Journal Entry,10565,PP01082021,NA,NA,Music,-Split-,NA,3774.35,200883.45
,,,1/8/2021,Journal Entry,10563,PP01082021,NA,NA,Admin,-Split-,NA,2655.22,203538.67
,,,1/11/2021,Bill,6584,cantor Christmas Eve,Bonnie Mootry,871,NA,2000 Accounts Payable,217,100,203638.67
,,,1/22/2021,Journal Entry,10564,PP01222021,NA,NA,Admin,-Split-,NA,3228.71,206867.38
,,,1/22/2021,Journal Entry,10567,PP01222021,NA,NA,Support Staff,-Split-,NA,1923.08,208790.46
,,,1/22/2021,Journal Entry,10567,PP01222021,NA,NA,Support Staff,-Split-,NA,5932.32,214722.78
,,,1/22/2021,Journal Entry,10567,PP01222021,NA,NA,GTL,-Split-,NA,-0.85,214721.93
,,,1/22/2021,Journal Entry,10567,PP01222021,NA,NA,Music,-Split-,NA,3624.35,218346.28
,,,1/22/2021,Bill,8405,1/8/2021 retro pay,Jennifer Henik,876,NA,2000 Accounts Payable,217,196.31,218542.59
,,,2/5/2021,Journal Entry,10589,PP02192022,NA,NA,Music,-Split-,NA,3349.85,221892.44
,,,2/5/2021,Journal Entry,10589,PP02192022,NA,NA,Support Staff,-Split-,NA,1923.08,223815.52
,,,2/5/2021,Journal Entry,10589,PP02192022,NA,NA,Support Staff,-Split-,NA,5562.89,229378.41
,,,2/5/2021,Journal Entry,10589,PP02192022,NA,NA,GTL,-Split-,NA,-0.85,229377.56
,,,2/5/2021,Journal Entry,10587,PP02052021,NA,NA,Admin,-Split-,NA,3490.68,232868.24
,,,2/19/2021,Journal Entry,10588,PP02192021,NA,NA,Admin,-Split-,NA,3247.36,236115.6
,,,2/19/2021,Journal Entry,10590,PP02192021,NA,NA,Music,-Split-,NA,3274.35,239389.95
,,,2/19/2021,Journal Entry,10590,PP02192021,NA,NA,GTL,-Split-,NA,-0.85,239389.1
,,,2/19/2021,Journal Entry,10590,PP02192021,NA,NA,Support Staff,-Split-,NA,1923.08,241312.18
,,,2/19/2021,Journal Entry,10590,PP02192021,NA,NA,Support Staff,-Split-,NA,5247.06,246559.24
,,,3/5/2021,Journal Entry,11029,PP20210305,NA,NA,Support Staff,-Split-,NA,1923.08,248482.32
,,,3/5/2021,Journal Entry,11029,PP20210305,NA,NA,Support Staff,-Split-,NA,5229.38,253711.7
,,,3/5/2021,Journal Entry,11029,PP20210305,NA,NA,Music,-Split-,NA,3274.35,256986.05
,,,3/5/2021,Journal Entry,11030,PP20210305,NA,NA,Admin,-Split-,NA,3228.71,260214.76
,,,3/5/2021,Journal Entry,11029,PP20210305,NA,NA,GTL,-Split-,NA,-0.85,260213.91
4016 House Staff,580,,,,,,,,,,,,
,,13719.2,,,,,,,,,,,
,,,1/8/2021,Journal Entry,10563,PP01082021,NA,NA,House,-Split-,NA,963.3,14682.5
,,,1/22/2021,Journal Entry,10564,PP01222021,NA,NA,House,-Split-,NA,1014,15696.5
,,,2/5/2021,Journal Entry,10587,PP02052021,NA,NA,House,-Split-,NA,1014,16710.5
,,,2/19/2021,Journal Entry,10588,PP02192021,NA,NA,House,-Split-,NA,1014,17724.5
,,,3/5/2021,Journal Entry,11030,PP20210305,NA,NA,House,-Split-,NA,1014,18738.5
4017 Maintenance - Church,396,,,,,,,,,,,,
,,72459.39,,,,,,,,,,,
,,,1/8/2021,Journal Entry,10563,PP01082021,NA,NA,Voided check,-Split-,NA,-424.43,72034.96
,,,1/8/2021,Journal Entry,10563,PP01082021,NA,NA,GTL,-Split-,NA,-4.57,72030.39
,,,1/8/2021,Journal Entry,10565,PP01082021,NA,NA,Housekeeper,-Split-,NA,3239.1,75269.49
,,,1/8/2021,Journal Entry,10563,PP01082021,NA,NA,Maintenance,-Split-,NA,2981.2,78250.69
,,,1/22/2021,Journal Entry,10564,PP01222021,NA,NA,GTL,-Split-,NA,-4.57,78246.12
,,,1/22/2021,Journal Entry,10564,PP01222021,NA,NA,Maintenance,-Split-,NA,2996.32,81242.44
,,,1/22/2021,Journal Entry,10567,PP01222021,NA,NA,Housekeeper,-Split-,NA,3239.1,84481.54
,,,2/5/2021,Journal Entry,10587,PP02052021,NA,NA,GTL,-Split-,NA,-4.57,84476.97
,,,2/5/2021,Journal Entry,10587,PP02052021,NA,NA,Maintenance,-Split-,NA,2371.76,86848.73
,,,2/5/2021,Journal Entry,10589,PP02192022,NA,NA,Housekeeper,-Split-,NA,2089.38,88938.11
,,,2/19/2021,Journal Entry,10590,PP02192021,NA,NA,Housekeeper,-Split-,NA,1918.13,90856.24
,,,2/19/2021,Journal Entry,10588,PP02192021,NA,NA,Maintenance,-Split-,NA,2594.42,93450.66
,,,2/19/2021,Journal Entry,10588,PP02192021,NA,NA,GTL,-Split-,NA,-4.57,93446.09
,,,3/5/2021,Journal Entry,11030,PP20210305,NA,NA,GTL,-Split-,NA,-4.57,93441.52
,,,3/5/2021,Journal Entry,11030,PP20210305,NA,NA,Maintenance,-Split-,NA,2784.26,96225.78
,,,3/5/2021,Journal Entry,11029,PP20210305,NA,NA,Housekeeper,-Split-,NA,3289.73,99515.51
4511 Administrators & Othr Schl Prof,639,,,,,,,,,,,,
,,136106.57,,,,,,,,,,,
,,,1/8/2021,Journal Entry,10565,PP01082021,NA,NA,Admins,-Split-,NA,-2.04,136104.53
,,,1/8/2021,Journal Entry,10565,PP01082021,NA,NA,Admins,-Split-,NA,10027.29,146131.82
,,,1/22/2021,Journal Entry,10567,PP01222021,NA,NA,Admins,-Split-,NA,10027.29,156159.11
,,,1/22/2021,Journal Entry,10567,PP01222021,NA,NA,Admins,-Split-,NA,-2.04,156157.07
,,,2/5/2021,Journal Entry,10589,PP02192022,NA,NA,Admins,-Split-,NA,-2.04,156155.03
,,,2/5/2021,Journal Entry,10589,PP02192022,NA,NA,Admins,-Split-,NA,11309.79,167464.82
,,,2/19/2021,Journal Entry,10590,PP02192021,NA,NA,Admins,-Split-,NA,-2.04,167462.78
,,,2/19/2021,Journal Entry,10590,PP02192021,NA,NA,Admins,-Split-,NA,10261.29,177724.07
,,,3/5/2021,Journal Entry,11029,PP20210305,NA,NA,Admins,-Split-,NA,10144.29,187868.36
,,,3/5/2021,Journal Entry,11029,PP20210305,NA,NA,Admins,-Split-,NA,-2.04,187866.32
4512 Religious Teachers,577,,,,,,,,,,,,
,,6366.45,,,,,,,,,,,
4513 Lay Teachers,690,,,,,,,,,,,,
,,705308.93,,,,,,,,,,,
,,,1/8/2021,Journal Entry,10565,PP01082021,NA,NA,Teachers,-Split-,NA,4633.61,709942.54
,,,1/8/2021,Journal Entry,10565,PP01082021,NA,NA,GTL,-Split-,NA,-3.56,709938.98
,,,1/8/2021,Journal Entry,10565,PP01082021,NA,NA,Teachers,-Split-,NA,43040.14,752979.12
,,,1/8/2021,Journal Entry,10563,PP01082021,NA,NA,Teachers,-Split-,NA,2786.9,755766.02
,,,1/8/2021,Journal Entry,10563,PP01082021,NA,NA,Teachers,-Split-,NA,2946.66,758712.68
,,,1/22/2021,Journal Entry,10567,PP01222021,NA,NA,Teachers,-Split-,NA,5862.49,764575.17
,,,1/22/2021,Journal Entry,10567,PP01222021,NA,NA,GTL,-Split-,NA,-3.56,764571.61
,,,1/22/2021,Journal Entry,10564,PP01222021,NA,NA,Teachers,-Split-,NA,3036.9,767608.51
,,,1/22/2021,Journal Entry,10564,PP01222021,NA,NA,Teachers,-Split-,NA,2946.66,770555.17
,,,1/22/2021,Journal Entry,10567,PP01222021,NA,NA,Teachers,-Split-,NA,44112.14,814667.31
,,,2/1/2021,Vendor Credit,8554,GR00035399,Catholic Bishop of Chicago (BillingSFXS),548,NA,2000 Accounts Payable,217,-17708.43,796958.88
,,,2/1/2021,Vendor Credit,8553,GR00035398,Catholic Bishop of Chicago (BillingSFXS),548,NA,2000 Accounts Payable,217,-2045.35,794913.53
,,,2/5/2021,Journal Entry,10589,PP02192022,NA,NA,Teachers,-Split-,NA,7934.86,802848.39
,,,2/5/2021,Journal Entry,10589,PP02192022,NA,NA,GTL,-Split-,NA,-3.56,802844.83
,,,2/5/2021,Journal Entry,10589,PP02192022,NA,NA,Teachers,-Split-,NA,54315.89,857160.72
,,,2/5/2021,Journal Entry,10587,PP02052021,NA,NA,Teachers,-Split-,NA,3506.66,860667.38
,,,2/5/2021,Journal Entry,10587,PP02052021,NA,NA,Teachers,-Split-,NA,3442.9,864110.28
,,,2/19/2021,Journal Entry,10588,PP02192021,NA,NA,Teachers,-Split-,NA,3021.66,867131.94
,,,2/19/2021,Journal Entry,10588,PP02192021,NA,NA,Teachers,-Split-,NA,2962.4,870094.34
,,,2/19/2021,Journal Entry,10590,PP02192021,NA,NA,Teachers,-Split-,NA,7128.24,877222.58
,,,2/19/2021,Journal Entry,10590,PP02192021,NA,NA,GTL,-Split-,NA,-3.56,877219.02
,,,2/19/2021,Journal Entry,10590,PP02192021,NA,NA,Teachers,-Split-,NA,45162.98,922382
,,,3/5/2021,Journal Entry,11029,PP20210305,NA,NA,GTL,-Split-,NA,-3.56,922378.44
,,,3/5/2021,Journal Entry,11030,PP20210305,NA,NA,Teachers,-Split-,NA,2903.9,925282.34
,,,3/5/2021,Journal Entry,11030,PP20210305,NA,NA,Teachers,-Split-,NA,3066.66,928349
,,,3/5/2021,Journal Entry,11029,PP20210305,NA,NA,Teachers,-Split-,NA,43549.39,971898.39
,,,3/5/2021,Journal Entry,11029,PP20210305,NA,NA,Teachers,-Split-,NA,6764.99,978663.38
4514 Special Program Teachers,578,,,,,,,,,,,,
,,360641.66,,,,,,,,,,,
,,,1/8/2021,Journal Entry,10565,PP01082021,NA,NA,Specials Teachers,-Split-,NA,20135.64,380777.3
,,,1/8/2021,Journal Entry,10563,PP01082021,NA,NA,Specials,-Split-,NA,2998.46,383775.76
,,,1/8/2021,Journal Entry,10565,PP01082021,NA,NA,GTL,-Split-,NA,-4.93,383770.83
,,,1/22/2021,Journal Entry,10564,PP01222021,NA,NA,Specials,-Split-,NA,3498.46,387269.29
,,,1/22/2021,Journal Entry,10567,PP01222021,NA,NA,Specials Teachers,-Split-,NA,23160.64,410429.93
,,,1/22/2021,Journal Entry,10567,PP01222021,NA,NA,GTL,-Split-,NA,-4.93,410425
,,,1/27/2021,Bill,8447,Irish Dance stipend,Claire Labuda,537,NA,2000 Accounts Payable,217,500,410925
,,,2/5/2021,Journal Entry,10587,PP02052021,NA,NA,Specials,-Split-,NA,3712.96,414637.96
,,,2/5/2021,Journal Entry,10589,PP02192022,NA,NA,GTL,-Split-,NA,-4.93,414633.03
,,,2/5/2021,Journal Entry,10589,PP02192022,NA,NA,Specials Teachers,-Split-,NA,25963.14,440596.17
,,,2/19/2021,Journal Entry,10590,PP02192021,NA,NA,GTL,-Split-,NA,-4.93,440591.24
,,,2/19/2021,Journal Entry,10590,PP02192021,NA,NA,Specials Teachers,-Split-,NA,23281.14,463872.38
,,,2/19/2021,Journal Entry,10588,PP02192021,NA,NA,Specials,-Split-,NA,3134.96,467007.34
,,,2/23/2021,Bill,8537,2021-STFX-6,"Fun Fluency, Inc",509,NA,2000 Accounts Payable,217,990,467997.34
,,,2/23/2021,Bill,8537,2021-STFX-6,"Fun Fluency, Inc",509,NA,2000 Accounts Payable,217,5525,473522.34
,,,2/23/2021,Bill,8536,1014,"Grage Management, LLC",487,Yoga,2000 Accounts Payable,217,212.5,473734.84
,,,3/5/2021,Journal Entry,11029,PP20210305,NA,NA,Specials Teachers,-Split-,NA,22994.64,496729.48
,,,3/5/2021,Journal Entry,11030,PP20210305,NA,NA,Specials,-Split-,NA,3173.96,499903.44
,,,3/5/2021,Journal Entry,11029,PP20210305,NA,NA,GTL,-Split-,NA,-4.93,499898.51
,,,3/10/2021,Bill,8643,1015,"Grage Management, LLC",487,NA,2000 Accounts Payable,217,700,500598.51
4515 Instructional Aides,640,,,,,,,,,,,,
,,200708.09,,,,,,,,,,,
,,,1/8/2021,Journal Entry,10565,PP01082021,NA,NA,Aides,-Split-,NA,2499.35,203207.44
,,,1/8/2021,Journal Entry,10565,PP01082021,NA,NA,Aides,-Split-,NA,5328.35,208535.79
,,,1/8/2021,Journal Entry,10563,PP01082021,NA,NA,Instructional Aide,-Split-,NA,630,209165.79
,,,1/8/2021,Journal Entry,10565,PP01082021,NA,NA,Aides,-Split-,NA,1230.08,210395.87
,,,1/22/2021,Journal Entry,10567,PP01222021,NA,NA,Aides,-Split-,NA,2377.73,212773.6
,,,1/22/2021,Journal Entry,10567,PP01222021,NA,NA,Aides,-Split-,NA,9945.35,222718.95
,,,1/22/2021,Journal Entry,10564,PP01222021,NA,NA,Instructional Aide,-Split-,NA,2284.86,225003.81
,,,1/22/2021,Journal Entry,10567,PP01222021,NA,NA,Aides,-Split-,NA,1230.08,226233.89
,,,1/25/2021,Bill,8411,2021-STFX-5,"Fun Fluency, Inc",509,NA,2000 Accounts Payable,217,990,227223.89
,,,1/25/2021,Bill,8411,2021-STFX-5,"Fun Fluency, Inc",509,NA,2000 Accounts Payable,217,5525,232748.89
,,,2/5/2021,Journal Entry,10587,PP02052021,NA,NA,Instructional Aide,-Split-,NA,2529.28,235278.17
,,,2/5/2021,Journal Entry,10589,PP02192022,NA,NA,Aides,-Split-,NA,13773.1,249051.27
,,,2/5/2021,Journal Entry,10589,PP02192022,NA,NA,Aides,-Split-,NA,3631.18,252682.45
,,,2/5/2021,Journal Entry,10589,PP02192022,NA,NA,Aides,-Split-,NA,2133.08,254815.53
,,,2/19/2021,Journal Entry,10590,PP02192021,NA,NA,Aides,-Split-,NA,2308.58,257124.11
,,,2/19/2021,Journal Entry,10588,PP02192021,NA,NA,Instructional Aide,-Split-,NA,1820.76,258944.87
,,,2/19/2021,Journal Entry,10590,PP02192021,NA,NA,Aides,-Split-,NA,12622.85,271567.72
,,,2/19/2021,Journal Entry,10590,PP02192021,NA,NA,Aides,-Split-,NA,3165.78,274733.5
,,,3/5/2021,Journal Entry,11030,PP20210305,NA,NA,Instructional Aide,-Split-,NA,1407.77,276141.27
,,,3/5/2021,Journal Entry,11029,PP20210305,NA,NA,Aides,-Split-,NA,3194.83,279336.1
,,,3/5/2021,Journal Entry,11029,PP20210305,NA,NA,Aides,-Split-,NA,11877.85,291213.95
,,,3/5/2021,Journal Entry,11029,PP20210305,NA,NA,Aides,-Split-,NA,2403.58,293617.53
4516 Substitute Teachers,579,,,,,,,,,,,,
,,41978.76,,,,,,,,,,,
,,,1/8/2021,Journal Entry,10565,PP01082021,NA,NA,Sub,-Split-,NA,2994.04,44972.8
,,,1/22/2021,Journal Entry,10567,PP01222021,NA,NA,Sub,-Split-,NA,3590.04,48562.84
,,,2/5/2021,Journal Entry,10589,PP02192022,NA,NA,Sub,-Split-,NA,7725.04,56287.88
,,,2/5/2021,Journal Entry,10587,PP02052021,NA,NA,Sub,-Split-,NA,281.25,56569.13
,,,2/19/2021,Journal Entry,10588,PP02192021,NA,NA,Sub,-Split-,NA,381.25,56950.38
,,,2/19/2021,Journal Entry,10590,PP02192021,NA,NA,Sub,-Split-,NA,4801.54,61751.92
,,,2/22/2021,Bill,8513,paycheck 4 days sub,Bridget Clancy,369,NA,2000 Accounts Payable,217,401.94,62153.86
,,,2/23/2021,Bill,8536,1014,"Grage Management, LLC",487,remote teacher,2000 Accounts Payable,217,200,62353.86
,,,3/5/2021,Journal Entry,11030,PP20210305,NA,NA,Sub,-Split-,NA,375,62728.86
,,,3/5/2021,Journal Entry,11029,PP20210305,NA,NA,Sub Adj Pay,-Split-,NA,-401.94,62326.92
,,,3/5/2021,Journal Entry,11029,PP20210305,NA,NA,Sub,-Split-,NA,5438.54,67765.46
4517 Support Staff - School,673,,,,,,,,,,,,
,,142708.42,,,,,,,,,,,
,,,1/8/2021,Journal Entry,10563,PP01082021,NA,NA,Admin Support Staff,-Split-,NA,389.34,143097.76
,,,1/8/2021,Journal Entry,10565,PP01082021,NA,NA,Admin Support Staff,-Split-,NA,-0.32,143097.44
,,,1/8/2021,Journal Entry,10565,PP01082021,NA,NA,Admin Support Staff,-Split-,NA,7689.48,150786.92
,,,1/22/2021,Journal Entry,10564,PP01222021,NA,NA,Admin Support Staff,-Split-,NA,1098,151884.92
,,,1/22/2021,Journal Entry,10567,PP01222021,NA,NA,Admin Support Staff,-Split-,NA,-0.32,151884.6
,,,1/22/2021,Journal Entry,10567,PP01222021,NA,NA,Admin Support Staff,-Split-,NA,12427.3,164311.9
,,,2/5/2021,Journal Entry,10587,PP02052021,NA,NA,Admin Support Staff,-Split-,NA,1517.5,165829.4
,,,2/5/2021,Journal Entry,10589,PP02192022,NA,NA,Admin Support Staff,-Split-,NA,13201.65,179031.05
,,,2/5/2021,Journal Entry,10589,PP02192022,NA,NA,Admin Support Staff,-Split-,NA,-0.32,179030.73
,,,2/9/2021,Bill,8462,reissue 1/8 payroll,Sean McNamara,363,NA,2000 Accounts Payable,217,424.43,179455.16
,,,2/19/2021,Journal Entry,10588,PP02192021,NA,NA,Admin Support Staff,-Split-,NA,1496,180951.16
,,,2/19/2021,Journal Entry,10590,PP02192021,NA,NA,Admin Support Staff,-Split-,NA,-0.32,180950.84
,,,2/19/2021,Journal Entry,10590,PP02192021,NA,NA,Admin Support Staff,-Split-,NA,12887.84,193838.68
,,,3/5/2021,Journal Entry,11029,PP20210305,NA,NA,Admin Support Staff,-Split-,NA,11476.35,205315.03
,,,3/5/2021,Journal Entry,11029,PP20210305,NA,NA,Admin Support Staff,-Split-,NA,-0.32,205314.71
,,,3/5/2021,Journal Entry,11030,PP20210305,NA,NA,Admin Support Staff,-Split-,NA,1550,206864.71
4518 Maintenance Staff - School,641,,,,,,,,,,,,
,,76288.57,,,,,,,,,,,
,,,1/8/2021,Journal Entry,10565,PP01082021,NA,NA,Maintenance,-Split-,NA,3843.35,80131.92
,,,1/8/2021,Journal Entry,10565,PP01082021,NA,NA,GTL,-Split-,NA,-3.35,80128.57
,,,1/22/2021,Journal Entry,10567,PP01222021,NA,NA,Maintenance,-Split-,NA,4203.35,84331.92
,,,1/22/2021,Journal Entry,10567,PP01222021,NA,NA,GTL,-Split-,NA,-3.35,84328.57
,,,2/5/2021,Journal Entry,10589,PP02192022,NA,NA,GTL,-Split-,NA,-3.35,84325.22
,,,2/5/2021,Journal Entry,10589,PP02192022,NA,NA,Maintenance,-Split-,NA,6232.95,90558.17
,,,2/19/2021,Journal Entry,10590,PP02192021,NA,NA,Maintenance,-Split-,NA,6038.45,96596.62
,,,2/19/2021,Journal Entry,10590,PP02192021,NA,NA,GTL,-Split-,NA,-3.35,96593.27
,,,3/5/2021,Journal Entry,11029,PP20210305,NA,NA,GTL,-Split-,NA,-3.35,96589.92
,,,3/5/2021,Journal Entry,11029,PP20210305,NA,NA,Maintenance,-Split-,NA,4453.35,101043.27
4030 Health Insurance-Employer Paid,163,,,,,,,,,,,,
,,341439,,,,,,,,,,,
,,,1/1/2021,Bill,8394,IB00181298,Catholic Bishop of Chicago (BillingSJS),547,NA,2000 Accounts Payable,217,5040,346479
,,,1/1/2021,Bill,8387,IB00181594,Catholic Bishop of Chicago (BillingSSJFX),359,NA,2000 Accounts Payable,217,14112,360591
,,,1/1/2021,Bill,8390,IB00181260,Catholic Bishop of Chicago (BillingSFXS),548,NA,2000 Accounts Payable,217,40320,400911
,,,1/1/2021,Bill,8391,IB00181261,Catholic Bishop of Chicago (BillingSFXS),548,NA,2000 Accounts Payable,217,3024,403935
,,,1/25/2021,Bill,8422,IB00181483,The Catholic Bishop of Chicago,230,NA,2000 Accounts Payable,217,38.5,403973.5
,,,2/1/2021,Bill,8574,IB00182192,Catholic Bishop of Chicago (BillingSSJFX),359,NA,2000 Accounts Payable,217,14112,418085.5
,,,2/1/2021,Bill,8558,IB00181875,Catholic Bishop of Chicago (BillingSFXS),548,NA,2000 Accounts Payable,217,2016,420101.5
,,,2/1/2021,Bill,8557,IB00181874,Catholic Bishop of Chicago (BillingSFXS),548,NA,2000 Accounts Payable,217,40320,460421.5
,,,2/1/2021,Bill,8583,IB00181907,Catholic Bishop of Chicago (BillingSJS),547,NA,2000 Accounts Payable,217,5040,465461.5
,,,3/1/2021,Bill,8575,IB00182785,Catholic Bishop of Chicago (BillingSSJFX),359,NA,2000 Accounts Payable,217,14112,479573.5
,,,3/1/2021,Bill,8559,IB00182471,Catholic Bishop of Chicago (BillingSFXS),548,NA,2000 Accounts Payable,217,40320,519893.5
,,,3/1/2021,Bill,8584,IB00182503,Catholic Bishop of Chicago (BillingSJS),547,NA,2000 Accounts Payable,217,5040,524933.5
,,,3/8/2021,Bill,8614,Feb health insurance,Catholic Bishop of Chicago,4,NA,2000 Accounts Payable,217,38.5,524972
4040 Employer FICA,164,,,,,,,,,,,,
,,166198.65,,,,,,,,,,,
,,,1/8/2021,Journal Entry,10565,PP01082021,NA,NA,FICA,-Split-,NA,6979.78,173178.43
,,,1/8/2021,Journal Entry,10565,PP01082021,NA,NA,FICA,-Split-,NA,0,173178.43
,,,1/8/2021,Journal Entry,10565,PP01082021,NA,NA,FICA,-Split-,NA,1502.69,174681.12
,,,1/8/2021,Journal Entry,10563,PP01082021,NA,NA,FICA,-Split-,NA,650.73,175331.85
,,,1/8/2021,Journal Entry,10563,PP01082021,NA,NA,FICA,-Split-,NA,0,175331.85
,,,1/8/2021,Journal Entry,10563,PP01082021,NA,NA,FICA,-Split-,NA,1137.95,176469.8
,,,1/22/2021,Journal Entry,10564,PP01222021,NA,NA,FICA,-Split-,NA,888.91,177358.71
,,,1/22/2021,Journal Entry,10564,PP01222021,NA,NA,FICA,-Split-,NA,0,177358.71
,,,1/22/2021,Journal Entry,10567,PP01222021,NA,NA,FICA,-Split-,NA,0,177358.71
,,,1/22/2021,Journal Entry,10567,PP01222021,NA,NA,FICA,-Split-,NA,8123.65,185482.36
,,,1/22/2021,Journal Entry,10567,PP01222021,NA,NA,FICA,-Split-,NA,1681.02,187163.38
,,,1/22/2021,Journal Entry,10564,PP01222021,NA,NA,FICA,-Split-,NA,1221.27,188384.65
,,,2/5/2021,Journal Entry,10587,PP02052021,NA,NA,FICA,-Split-,NA,1051.52,189436.17
,,,2/5/2021,Journal Entry,10587,PP02052021,NA,NA,FICA,-Split-,NA,0,189436.17
,,,2/5/2021,Journal Entry,10587,PP02052021,NA,NA,FICA,-Split-,NA,1138.07,190574.24
,,,2/5/2021,Journal Entry,10589,PP02192022,NA,NA,FICA,-Split-,NA,10159.8,200734.04
,,,2/5/2021,Journal Entry,10589,PP02192022,NA,NA,FICA,-Split-,NA,0,200734.04
,,,2/5/2021,Journal Entry,10589,PP02192022,NA,NA,FICA,-Split-,NA,1677.99,202412.03
,,,2/19/2021,Journal Entry,10588,PP02192021,NA,NA,FICA,-Split-,NA,885.24,203297.27
,,,2/19/2021,Journal Entry,10590,PP02192021,NA,NA,FICA,-Split-,NA,0,203297.27
,,,2/19/2021,Journal Entry,10590,PP02192021,NA,NA,FICA,-Split-,NA,8794.56,212091.83
,,,2/19/2021,Journal Entry,10590,PP02192021,NA,NA,FICA,-Split-,NA,1620.1,213711.93
,,,2/19/2021,Journal Entry,10588,PP02192021,NA,NA,FICA,-Split-,NA,1086.7,214798.63
,,,2/19/2021,Journal Entry,10588,PP02192021,NA,NA,FICA,-Split-,NA,0,214798.63
,,,3/5/2021,Journal Entry,11030,PP20210305,NA,NA,FICA,-Split-,NA,859.25,215657.88
,,,3/5/2021,Journal Entry,11030,PP20210305,NA,NA,FICA,-Split-,NA,1124.65,216782.53
,,,3/5/2021,Journal Entry,11029,PP20210305,NA,NA,FICA,-Split-,NA,8527.59,225310.12
,,,3/5/2021,Journal Entry,11029,PP20210305,NA,NA,FICA,-Split-,NA,0,225310.12
,,,3/5/2021,Journal Entry,11029,PP20210305,NA,NA,FICA,-Split-,NA,1602.42,226912.54
,,,3/5/2021,Journal Entry,11030,PP20210305,NA,NA,FICA,-Split-,NA,0,226912.54
4050 Fringe Benefits,186,,,,,,,,,,,,
4052 Fringe Benefits - Lay,NA,,,,,,,,,,,,
,,53206.62,,,,,,,,,,,
,,,1/1/2021,Bill,8395,IR00148161,Catholic Bishop of Chicago (BillingSJS),547,NA,2000 Accounts Payable,217,614,53820.62
,,,1/1/2021,Bill,8388,IR00148317,Catholic Bishop of Chicago (BillingSSJFX),359,NA,2000 Accounts Payable,217,2337,56157.62
,,,1/1/2021,Bill,8392,IR00148130,Catholic Bishop of Chicago (BillingSFXS),548,NA,2000 Accounts Payable,217,6709,62866.62
,,,2/1/2021,Bill,8576,IR00148769,Catholic Bishop of Chicago (BillingSSJFX),359,NA,2000 Accounts Payable,217,2341,65207.62
,,,2/1/2021,Bill,8560,IR00148582,Catholic Bishop of Chicago (BillingSFXS),548,NA,2000 Accounts Payable,217,6776,71983.62
,,,2/1/2021,Bill,8585,IR00148613,Catholic Bishop of Chicago (BillingSJS),547,NA,2000 Accounts Payable,217,614,72597.62
,,,3/1/2021,Bill,8577,IR00149220,Catholic Bishop of Chicago (BillingSSJFX),359,NA,2000 Accounts Payable,217,2341,74938.62
,,,3/1/2021,Bill,8561,IR00149034,Catholic Bishop of Chicago (BillingSFXS),548,NA,2000 Accounts Payable,217,6879,81817.62
,,,3/1/2021,Bill,8586,IR00149065,Catholic Bishop of Chicago (BillingSJS),547,NA,2000 Accounts Payable,217,614,82431.62
4060 Prof. Growth/Minist./Other,189,,,,,,,,,,,,
4061 Professional Growth,NA,,,,,,,,,,,,
,,10821.87,,,,,,,,,,,
,,,1/27/2021,Bill,8445,RR PD,Eileen Kirk,711,NA,2000 Accounts Payable,217,195,11016.87
,,,2/22/2021,Bill,8511,RR PD,Collin McShane,568,NA,2000 Accounts Payable,217,249.99,11266.86
,,,2/22/2021,Bill,8522,RR PD,Caroline Head,706,NA,2000 Accounts Payable,217,99,11365.86
,,,2/22/2021,Bill,8490,RR prof dev,Mary Kate Georgalas,47,NA,2000 Accounts Payable,217,10,11375.86
,,,3/8/2021,Bill,8595,RR PD,Annie Buxton,623,NA,2000 Accounts Payable,217,225,11600.86
,,,3/10/2021,Bill,8640,RR PD,Joanne Brinceanu,389,NA,2000 Accounts Payable,217,275,11875.86
,,,3/10/2021,Bill,8642,RR PD,Jennifer Miller,262,NA,2000 Accounts Payable,217,2200,14075.86
,,,3/10/2021,Bill,8637,RR PD,Jaime Vehovsky,48,NA,2000 Accounts Payable,217,127,14202.86
4062 Ministerial Expense Allowance,568,,,,,,,,,,,,
,,1247.5,,,,,,,,,,,
4063 Unemployment Compensation,581,,,,,,,,,,,,
,,416,,,,,,,,,,,
,,,1/28/2021,Bill,8565,AF00033555,Catholic Bishop of Chicago (BillingSSJFX),359,NA,2000 Accounts Payable,217,679,1095
,,,1/28/2021,Bill,8581,AF00033510,Catholic Bishop of Chicago (BillingSJS),547,NA,2000 Accounts Payable,217,7872,8967
"4100 Books & Supplies,Non-Liturgical",169,,,,,,,,,,,,
4102 Offertory Supplies,NA,,,,,,,,,,,,
,,40.04,,,,,,,,,,,
,,,3/10/2021,Bill,7206,8061346952,Staples SJ,92,NA,2000 Accounts Payable,217,220.09,260.13
,,,3/10/2021,Bill,7206,8061346952,Staples SJ,92,NA,2000 Accounts Payable,217,220.1,480.23
4103 Books and Magazines,170,,,,,,,,,,,,
,,4362.62,,,,,,,,,,,
4105 Textbooks,561,,,,,,,,,,,,
,,16481.39,,,,,,,,,,,
,,,1/11/2021,Vendor Credit,6585,SFX92120,Heinemann,405,NA,2000 Accounts Payable,217,-180,16301.39
,,,1/25/2021,Bill,8430,7016248,Loyola Press YFF,833,NA,2000 Accounts Payable,217,3938.42,20239.81
,,,2/28/2021,Journal Entry,10802,SUN210228,NA,NA,crossland literacy,-Split-,NA,-330,19909.81
4106 Workbooks,688,,,,,,,,,,,,
,,20483.95,,,,,,,,,,,
,,,1/11/2021,Bill,6569,107211,Monk's WIne and Candles SSJFX,65,NA,2000 Accounts Payable,217,83.7,20567.65
,,,1/25/2021,Bill,8427,bal due,Gospel Weeklies,237,NA,2000 Accounts Payable,217,85.22,20652.87
,,,3/8/2021,Bill,8611,7017987,Loyola Press SFX SCH,400,NA,2000 Accounts Payable,217,937.44,21590.31
,,,3/10/2021,Bill,7185,7018395,Loyola Press YFF,833,NA,2000 Accounts Payable,217,781.2,22371.51
4107 Library Materials,562,,,,,,,,,,,,
,,1158.21,,,,,,,,,,,
,,,2/22/2021,Bill,8501,RR Books,Linda Sawyer,243,NA,2000 Accounts Payable,217,16.48,1174.69
,,,2/23/2021,Bill,8545,549718,Junior Library Guild,245,NA,2000 Accounts Payable,217,163.55,1338.24
,,,2/23/2021,Bill,8544,549615,Junior Library Guild,245,NA,2000 Accounts Payable,217,245.05,1583.29
,,,3/10/2021,Bill,8636,551793,Junior Library Guild,245,NA,2000 Accounts Payable,217,195,1778.29
4109 Instructional Materials,563,,,,,,,,,,,,
,,54297.6,,,,,,,,,,,
,,,1/12/2021,Bill,8071,INV99812,Learning Without Tears,404,NA,2000 Accounts Payable,217,22.7,54320.3
,,,1/27/2021,Bill,8446,955074345,Houghton Mifflin Harcourt,189,NA,2000 Accounts Payable,217,2724.1,57044.4
,,,1/27/2021,Bill,8441,4026270889,"Savvas Learning Company, LLC",832,NA,2000 Accounts Payable,217,1428.26,58472.66
,,,2/3/2021,Journal Entry,10583,MD 210203,NA,NA,NA,-Split-,NA,-2717.76,55754.9
,,,2/22/2021,Bill,8524,mult invoices,Garvey's Office Products,134,NA,2000 Accounts Payable,217,579.79,56334.69
,,,2/22/2021,Bill,8496,7027411209,"Savvas Learning Company, LLC",832,NA,2000 Accounts Payable,217,49.88,56384.57
,,,2/22/2021,Bill,8512,RR Winter book club,Nicole Collins,272,NA,2000 Accounts Payable,217,97.98,56482.55
,,,2/22/2021,Bill,8502,PINV2030285,Garvey's Office Products,134,NA,2000 Accounts Payable,217,67.92,56550.47
,,,2/22/2021,Bill,8488,RR registration,Hillary Richards,741,NA,2000 Accounts Payable,217,274,56824.47
,,,3/8/2021,Bill,8602,4026292062,"Savvas Learning Company, LLC",832,NA,2000 Accounts Payable,217,134.46,56958.93
,,,3/8/2021,Bill,8602,4026292062,"Savvas Learning Company, LLC",832,NA,2000 Accounts Payable,217,134.46,57093.39
,,,3/8/2021,Bill,8596,RR Supplies/Snacks,Jennifer Miller,262,NA,2000 Accounts Payable,217,38,57131.39
,,,3/10/2021,Bill,8639,CSUM 134782,Garvey's Office Products,134,NA,2000 Accounts Payable,217,884.9,58016.29
,,,3/10/2021,Bill,8639,CSUM 134782,Garvey's Office Products,134,NA,2000 Accounts Payable,217,368.56,58384.85
4110 Instructional Software,187,,,,,,,,,,,,
,,12330.84,,,,,,,,,,,
,,,2/22/2021,Bill,8510,S396700,1XL Learning,582,NA,2000 Accounts Payable,217,6317,18647.84
4150 Administrative Expenses,47,,,,,,,,,,,,
4151 Ofc Equipment-Supplies & Maint.,NA,,,,,,,,,,,,
,,9624.92,,,,,,,,,,,
,,,1/11/2021,Bill,6581,8060733105,Staples SJ,92,3465016442 printer toner,2000 Accounts Payable,217,450.44,10075.36
,,,1/11/2021,Bill,6581,8060733105,Staples SJ,92,3465016443 printer toner,2000 Accounts Payable,217,216.99,10292.35
,,,1/11/2021,Bill,8373,4034960578,Canon Maintanence,563,NA,2000 Accounts Payable,217,93.26,10385.61
,,,1/11/2021,Bill,8372,4034960577,Canon Maintanence,563,NA,2000 Accounts Payable,217,15.34,10400.95
,,,1/11/2021,Bill,6581,8060733105,Staples SJ,92,3465016444 printer toner,2000 Accounts Payable,217,216.09,10617.04
,,,2/8/2021,Bill,7140,4035261443,Canon Maintanence,563,NA,2000 Accounts Payable,217,160.08,10777.12
,,,2/8/2021,Bill,7140,4035261443,Canon Maintanence,563,NA,2000 Accounts Payable,217,160.08,10937.2
,,,2/9/2021,Bill,8460,4035274526,Canon Maintanence,563,NA,2000 Accounts Payable,217,331.59,11268.79
,,,2/9/2021,Bill,7165,147181608,Canon Maintanence,563,NA,2000 Accounts Payable,217,204,11472.79
,,,2/9/2021,Bill,7172,4035253231,Canon Maintanence,563,NA,2000 Accounts Payable,217,7.98,11480.77
,,,2/9/2021,Bill,7173,4035253232,Canon Maintanence,563,NA,2000 Accounts Payable,217,35.9,11516.67
,,,2/22/2021,Bill,8505,PINV2029174,Garvey's Office Products,134,NA,2000 Accounts Payable,217,15.78,11532.45
,,,3/8/2021,Bill,8613,1966149-00,Barton Cotton,895,NA,2000 Accounts Payable,217,252.51,11784.96
,,,3/8/2021,Bill,8603,1017530500,Pitney Bowes SFXS 0015503825,488,NA,2000 Accounts Payable,217,293.45,12078.41
,,,3/10/2021,Bill,8651,145604,GO Technology Group Inc.,64,NA,2000 Accounts Payable,217,1600,13678.41
,,,3/10/2021,Bill,7190,4035560484,Canon Maintanence,563,NA,2000 Accounts Payable,217,308.89,13987.3
,,,3/10/2021,Bill,7188,4035561859,Canon Maintanence,563,NA,2000 Accounts Payable,217,216.09,14203.39
,,,3/10/2021,Bill,7187,4035561858,Canon Maintanence,563,NA,2000 Accounts Payable,217,111.29,14314.68
,,,3/10/2021,Bill,7189,4035561857,Canon Maintanence,563,NA,2000 Accounts Payable,217,11.1,14325.78
4152 Outside Printing Cost,48,,,,,,,,,,,,
,,18203.47,,,,,,,,,,,
,,,1/11/2021,Bill,6589,121548,Elk Grove Graphics,485,thanksgiving post card,2000 Accounts Payable,217,991.98,19195.45
,,,1/25/2021,Bill,8406,428624,Church Budget,28,NA,2000 Accounts Payable,217,601.18,19796.63
,,,3/8/2021,Bill,8601,56106,Printwell,418,NA,2000 Accounts Payable,217,500,20296.63
4153 Postage/Courier Services,49,,,,,,,,,,,,
,,3038.19,,,,,,,,,,,
,,,1/12/2021,Bill,8060,Feb 2021 statement,Pitney Bowes Purchase Power SFXCH 6704,806,NA,2000 Accounts Payable,217,534.85,3573.04
,,,1/25/2021,Bill,8421,RR stamps,Anne Hrabe,878,NA,2000 Accounts Payable,217,660,4233.04
,,,2/9/2021,Bill,8455,RR bulletins,Sara Crome,631,NA,2000 Accounts Payable,217,9.05,4242.09
,,,2/9/2021,Bill,7170,March statement,Pitney Bowes Purchase Power SFXCH 6704,806,postage at SFX,2000 Accounts Payable,217,503.5,4745.59
4154 Office Supplies,50,,,,,,,,,,,,
,,7860.37,,,,,,,,,,,
,,,1/11/2021,Bill,6581,8060733105,Staples SJ,92,coffee and cups,2000 Accounts Payable,217,35.04,7895.41
,,,1/11/2021,Bill,6572,MAT-182049,A SmartSign Store,567,NA,2000 Accounts Payable,217,635.36,8530.77
,,,1/11/2021,Bill,6581,8060733105,Staples SJ,92,coffee,2000 Accounts Payable,217,117.11,8647.88
,,,1/11/2021,Bill,6581,8060733105,Staples SJ,92,hot choc,2000 Accounts Payable,217,30.58,8678.46
,,,1/11/2021,Bill,6581,8060733105,Staples SJ,92,"3465016441 labels, pens, tape",2000 Accounts Payable,217,47.72,8726.18
,,,1/11/2021,Bill,6581,8060733105,Staples SJ,92,3465016437 plastic tote,2000 Accounts Payable,217,125.99,8852.17
,,,1/12/2021,Bill,8380,RR music/office exp,John Hopkins,101,NA,2000 Accounts Payable,217,64.89,8917.06
,,,1/12/2021,Bill,8075,RR reprint from 12/7,John Hopkins,101,supplies,2000 Accounts Payable,217,40.04,8957.1
,,,2/9/2021,Bill,8452,RR key/planner,John Hopkins,101,NA,2000 Accounts Payable,217,3.99,8961.09
,,,2/9/2021,Bill,7177,8061011664,Staples SJ,92,3467316423,2000 Accounts Payable,217,97,9058.09
,,,2/9/2021,Bill,7177,8061011664,Staples SJ,92,3467316424,2000 Accounts Payable,217,18.61,9076.7
,,,2/9/2021,Bill,7177,8061011664,Staples SJ,92,3467316416 credit,2000 Accounts Payable,217,-18.99,9057.71
,,,2/9/2021,Bill,7177,8061011664,Staples SJ,92,3467316422,2000 Accounts Payable,217,62.46,9120.17
,,,2/9/2021,Bill,7177,8061011664,Staples SJ,92,3467316420,2000 Accounts Payable,217,349.62,9469.79
,,,2/9/2021,Bill,7177,8061011664,Staples SJ,92,3467316419 credit,2000 Accounts Payable,217,-48.13,9421.66
,,,2/9/2021,Bill,7177,8061011664,Staples SJ,92,3467316418 credit,2000 Accounts Payable,217,-30.58,9391.08
,,,2/22/2021,Bill,8506,PINV2028178,Garvey's Office Products,134,NA,2000 Accounts Payable,217,139.6,9530.68
,,,2/22/2021,Bill,8504,PINV2028689,Garvey's Office Products,134,NA,2000 Accounts Payable,217,118.3,9648.98
,,,2/22/2021,Bill,8499,28525,Bye-Mor Inc.,284,NA,2000 Accounts Payable,217,132,9780.98
,,,2/22/2021,Bill,8503,PINV2029595,Garvey's Office Products,134,NA,2000 Accounts Payable,217,6.14,9787.12
4155 Professional Service Fees,51,,,,,,,,,,,,
,,63309.52,,,,,,,,,,,
,,,1/1/2021,Deposit,4352,NA,NA,NA,fees withheld,1101.10 Cash:Saints JFX Oper. Acct. #2264:Checking Available,691,40,63349.52
,,,1/5/2021,Deposit,4167,NA,NA,NA,admin withheld,1101.10 Cash:Saints JFX Oper. Acct. #2264:Checking Available,691,36,63385.52
,,,1/5/2021,Deposit,4167,NA,NA,NA,fees withheld,1101.10 Cash:Saints JFX Oper. Acct. #2264:Checking Available,691,280,63665.52
,,,1/8/2021,Journal Entry,10565,PP01082021,NA,NA,IOI Fee,-Split-,NA,71.05,63736.57
,,,1/8/2021,Journal Entry,10565,PP01082021,NA,NA,IOI Fee,-Split-,NA,71.05,63807.62
,,,1/8/2021,Journal Entry,10563,PP01082021,NA,NA,IOI Fee,-Split-,NA,29.15,63836.77
,,,1/8/2021,Journal Entry,10563,PP01082021,NA,NA,IOI Fee,-Split-,NA,29.16,63865.93
,,,1/8/2021,Deposit,4168,NA,NA,NA,fees withheld,1101.10 Cash:Saints JFX Oper. Acct. #2264:Checking Available,691,40,63905.93
,,,1/11/2021,Bill,6570,1372,Americhoice Radon Testing,869,NA,2000 Accounts Payable,217,500,64405.93
,,,1/11/2021,Bill,8371,145450,GO Technology Group Inc.,64,NA,2000 Accounts Payable,217,1600,66005.93
,,,1/12/2021,Bill,8080,MJ12010733,Lapels of Wilmette SJC,426,NA,2000 Accounts Payable,217,60,66065.93
,,,1/13/2021,Bill,8399,MJ12010330,Lapels of WIlmette SFX Rectory Cleaning,58,NA,2000 Accounts Payable,217,24,66089.93
,,,1/15/2021,Deposit,4174,NA,NA,NA,fees withheld,1101.10 Cash:Saints JFX Oper. Acct. #2264:Checking Available,691,80,66169.93
,,,1/15/2021,Deposit,4169,NA,NA,NA,fees withheld,1101.10 Cash:Saints JFX Oper. Acct. #2264:Checking Available,691,480,66649.93
,,,1/22/2021,Journal Entry,10567,PP01222021,NA,NA,IOI Fee,-Split-,NA,83.2,66733.13
,,,1/22/2021,Journal Entry,10564,PP01222021,NA,NA,IOI Fee,-Split-,NA,26.09,66759.22
,,,1/22/2021,Journal Entry,10564,PP01222021,NA,NA,IOI Fee,-Split-,NA,26.1,66785.32
,,,1/22/2021,Journal Entry,10567,PP01222021,NA,NA,IOI Fee,-Split-,NA,83.2,66868.52
,,,1/25/2021,Bill,8419,68636,Crescent Cleaning Company,820,NA,2000 Accounts Payable,217,6626,73494.52
,,,1/25/2021,Bill,8419,68636,Crescent Cleaning Company,820,NA,2000 Accounts Payable,217,1510,75004.52
,,,1/25/2021,Bill,8419,68636,Crescent Cleaning Company,820,NA,2000 Accounts Payable,217,902.19,75906.71
,,,1/25/2021,Bill,8419,68636,Crescent Cleaning Company,820,retro sept-dec,2000 Accounts Payable,217,2550,78456.71
,,,1/25/2021,Bill,8420,68122,Crescent Cleaning Company,820,NA,2000 Accounts Payable,217,706,79162.71
,,,1/25/2021,Bill,8420,68122,Crescent Cleaning Company,820,NA,2000 Accounts Payable,217,2412.19,81574.9
,,,1/25/2021,Bill,8420,68122,Crescent Cleaning Company,820,NA,2000 Accounts Payable,217,1510,83084.9
,,,1/25/2021,Bill,8420,68122,Crescent Cleaning Company,820,NA,2000 Accounts Payable,217,6626,89710.9
,,,1/25/2021,Bill,8419,68636,Crescent Cleaning Company,820,NA,2000 Accounts Payable,217,706,90416.9
,,,1/25/2021,Bill,8419,68636,Crescent Cleaning Company,820,NA,2000 Accounts Payable,217,5335,95751.9
,,,1/25/2021,Deposit,4171,NA,NA,NA,fees withheld,1101.10 Cash:Saints JFX Oper. Acct. #2264:Checking Available,691,240,95991.9
,,,1/27/2021,Bill,8443,7186942,Anderson Pest Solutions SFX,66,NA,2000 Accounts Payable,217,79.83,96071.73
,,,1/29/2021,Bill,8582,AF00033721,Catholic Bishop of Chicago (BillingSJS),547,NA,2000 Accounts Payable,217,750,96821.73
,,,1/29/2021,Deposit,4178,NA,NA,NA,admin withheld,1101.10 Cash:Saints JFX Oper. Acct. #2264:Checking Available,691,36,96857.73
,,,1/29/2021,Deposit,4178,NA,NA,NA,fees withheld,1101.10 Cash:Saints JFX Oper. Acct. #2264:Checking Available,691,40,96897.73
,,,1/29/2021,Deposit,4177,NA,NA,NA,fees withheld,1101.10 Cash:Saints JFX Oper. Acct. #2264:Checking Available,691,240,97137.73
,,,1/29/2021,Bill,8555,AF00033699,Catholic Bishop of Chicago (BillingSFXS),548,NA,2000 Accounts Payable,217,750,97887.73
,,,2/5/2021,Journal Entry,10587,PP02052021,NA,NA,IOI Fee,-Split-,NA,118.37,98006.1
,,,2/5/2021,Journal Entry,10587,PP02052021,NA,NA,IOI Fee,-Split-,NA,118.37,98124.47
,,,2/5/2021,Deposit,4466,NA,NA,NA,fees withheld,1101.10 Cash:Saints JFX Oper. Acct. #2264:Checking Available,691,220,98344.47
,,,2/5/2021,Journal Entry,10589,PP02192022,NA,NA,IOI Fee,-Split-,NA,384.29,98728.76
,,,2/5/2021,Journal Entry,10589,PP02192022,NA,NA,IOI Fee,-Split-,NA,384.29,99113.05
,,,2/9/2021,Bill,7161,68846,Crescent Cleaning Company,820,Sept - Dec retro hours,2000 Accounts Payable,217,2550,101663.05
,,,2/9/2021,Bill,7162,404269423,Terminix SJS,23,NA,2000 Accounts Payable,217,73,101736.05
,,,2/9/2021,Bill,7163,404296527,Terminix SJC,179,NA,2000 Accounts Payable,217,94,101830.05
,,,2/9/2021,Bill,8458,145525,GO Technology Group Inc.,64,NA,2000 Accounts Payable,217,1600,103430.05
,,,2/9/2021,Bill,7161,68846,Crescent Cleaning Company,820,addtl hours in Feb,2000 Accounts Payable,217,902.19,104332.24
,,,2/9/2021,Bill,7161,68846,Crescent Cleaning Company,820,NA,2000 Accounts Payable,217,706,105038.24
,,,2/9/2021,Bill,7161,68846,Crescent Cleaning Company,820,NA,2000 Accounts Payable,217,5335,110373.24
,,,2/9/2021,Bill,7161,68846,Crescent Cleaning Company,820,NA,2000 Accounts Payable,217,1510,111883.24
,,,2/9/2021,Bill,7161,68846,Crescent Cleaning Company,820,NA,2000 Accounts Payable,217,6626,118509.24
,,,2/10/2021,Deposit,4456,NA,NA,NA,late fees in school,1101.10 Cash:Saints JFX Oper. Acct. #2264:Checking Available,691,40,118549.24
,,,2/10/2021,Deposit,4456,NA,NA,NA,admin withheld,1101.10 Cash:Saints JFX Oper. Acct. #2264:Checking Available,691,72,118621.24
,,,2/10/2021,Deposit,4456,NA,NA,NA,smart fees withheld,1101.10 Cash:Saints JFX Oper. Acct. #2264:Checking Available,691,360,118981.24
,,,2/12/2021,Deposit,4464,NA,NA,NA,fees withheld,1101.10 Cash:Saints JFX Oper. Acct. #2264:Checking Available,691,40,119021.24
,,,2/12/2021,Deposit,4467,NA,NA,NA,fees withheld,1101.10 Cash:Saints JFX Oper. Acct. #2264:Checking Available,691,160,119181.24
,,,2/12/2021,Deposit,4464,NA,NA,NA,admin withheld,1101.10 Cash:Saints JFX Oper. Acct. #2264:Checking Available,691,36,119217.24
,,,2/19/2021,Journal Entry,10590,PP02192021,NA,NA,IOI Fee,-Split-,NA,84.62,119301.86
,,,2/19/2021,Journal Entry,10590,PP02192021,NA,NA,IOI Fee,-Split-,NA,84.61,119386.47
,,,2/19/2021,Journal Entry,10588,PP02192021,NA,NA,IOI Fee,-Split-,NA,24.34,119410.81
,,,2/19/2021,Journal Entry,10588,PP02192021,NA,NA,IOI Fee,-Split-,NA,24.34,119435.15
,,,2/19/2021,Deposit,4458,NA,NA,NA,fees withheld,1101.10 Cash:Saints JFX Oper. Acct. #2264:Checking Available,691,40,119475.15
,,,2/19/2021,Deposit,4457,NA,NA,NA,fees withheld,1101.10 Cash:Saints JFX Oper. Acct. #2264:Checking Available,691,80,119555.15
,,,2/19/2021,Deposit,4457,NA,NA,NA,admin withheld,1101.10 Cash:Saints JFX Oper. Acct. #2264:Checking Available,691,36,119591.15
,,,2/22/2021,Bill,8520,Feb 11 tuning,"Robert Portle, M.M.",718,NA,2000 Accounts Payable,217,88,119679.15
,,,2/22/2021,Bill,8497,7385144,Anderson Pest Solutions SFX,66,NA,2000 Accounts Payable,217,79.83,119758.98
,,,2/22/2021,Bill,8516,404611312,Terminix SJC,179,NA,2000 Accounts Payable,217,94,119852.98
,,,2/22/2021,Bill,8517,404612529,Terminix SJS,23,NA,2000 Accounts Payable,217,73,119925.98
,,,2/25/2021,Deposit,4459,NA,NA,NA,fees withheld,1101.10 Cash:Saints JFX Oper. Acct. #2264:Checking Available,691,40,119965.98
,,,2/25/2021,Deposit,4459,NA,NA,NA,admin withheld,1101.10 Cash:Saints JFX Oper. Acct. #2264:Checking Available,691,72,120037.98
,,,3/5/2021,Journal Entry,11029,PP20210305,NA,NA,IOI Fee,-Split-,NA,84.81,120122.79
,,,3/5/2021,Journal Entry,11029,PP20210305,NA,NA,IOI Fee,-Split-,NA,84.81,120207.6
,,,3/5/2021,Journal Entry,11030,PP20210305,NA,NA,IOI Fee,-Split-,NA,25.13,120232.73
,,,3/5/2021,Journal Entry,11030,PP20210305,NA,NA,IOI Fee,-Split-,NA,25.12,120257.85
,,,3/8/2021,Bill,8609,69073,Crescent Cleaning Company,820,Retro Sept - Dec,2000 Accounts Payable,217,2550,122807.85
,,,3/8/2021,Bill,8609,69073,Crescent Cleaning Company,820,addtl hours March 2021,2000 Accounts Payable,217,902.19,123710.04
,,,3/8/2021,Bill,8609,69073,Crescent Cleaning Company,820,NA,2000 Accounts Payable,217,6626,130336.04
,,,3/8/2021,Bill,8609,69073,Crescent Cleaning Company,820,NA,2000 Accounts Payable,217,1510,131846.04
,,,3/8/2021,Bill,8609,69073,Crescent Cleaning Company,820,NA,2000 Accounts Payable,217,706,132552.04
,,,3/8/2021,Bill,8609,69073,Crescent Cleaning Company,820,NA,2000 Accounts Payable,217,5335,137887.04
,,,3/8/2021,Bill,8608,69167,Crescent Cleaning Company,820,NA,2000 Accounts Payable,217,109.99,137997.03
,,,3/8/2021,Bill,8608,69167,Crescent Cleaning Company,820,NA,2000 Accounts Payable,217,109.99,138107.02
,,,3/10/2021,Bill,8633,RR,Wayne Watts,241,NA,2000 Accounts Payable,217,14.36,138121.38
4156 Computer Supplies,185,,,,,,,,,,,,
,,25689.18,,,,,,,,,,,
,,,3/10/2021,Bill,8638,RR apple pencil,Patti Tsuru,886,NA,2000 Accounts Payable,217,89,25778.18
,,,3/10/2021,Bill,8635,office 365,Archdiocese of Chicago,96,NA,2000 Accounts Payable,217,23.28,25801.46
4157 Criminal Background Checks,52,,,,,,,,,,,,
,,1123.09,,,,,,,,,,,
,,,1/11/2021,Bill,6573,110952012,Accurate Biometrics,24,NA,2000 Accounts Payable,217,46.5,1169.59
,,,2/9/2021,Bill,7181,110952101,Accurate Biometrics,24,NA,2000 Accounts Payable,217,139.5,1309.09
,,,2/9/2021,Bill,7168,Dec statement,"S2Verify, LLC",94,NA,2000 Accounts Payable,217,24.52,1333.61
,,,2/9/2021,Bill,7169,Dec 2 statement,"S2Verify, LLC",94,NA,2000 Accounts Payable,217,58.26,1391.87
,,,2/22/2021,Bill,8491,backround checks,"S2Verify, LLC",94,NA,2000 Accounts Payable,217,103.36,1495.23
,,,2/22/2021,Bill,8514,110952011,Accurate Biometrics,24,NA,2000 Accounts Payable,217,279,1774.23
,,,3/8/2021,Bill,8597,RR background check,Amy Butterworth,119,NA,2000 Accounts Payable,217,20,1794.23
,,,3/10/2021,Bill,8641,RR background check,George Weschler,291,NA,2000 Accounts Payable,217,7,1801.23
4158 Bank Fees,386,,,,,,,,,,,,
,,25013.35,,,,,,,,,,,
,,,1/4/2021,Check,8973,ACH,bank Fee,346,NA,1101.10 Cash:Saints JFX Oper. Acct. #2264:Checking Available,691,7078.39,32091.74
,,,1/5/2021,Check,8974,ACH,First Fund,340,NA,1101.10 Cash:Saints JFX Oper. Acct. #2264:Checking Available,691,333.93,32425.67
,,,1/6/2021,Check,8975,ACH,Stop Payment,358,NA,1101.10 Cash:Saints JFX Oper. Acct. #2264:Checking Available,691,100,32525.67
,,,1/6/2021,Deposit,4452,NA,NA,NA,NA,1106.01 Cash:Old St. Joseph Accounts:St. Joseph #XXXX Oper (Old) BMO,330,5.99,32531.66
,,,1/7/2021,Check,8976,ach,acct adjustment,366,Dr,1101.10 Cash:Saints JFX Oper. Acct. #2264:Checking Available,691,118,32649.66
,,,1/15/2021,Check,8979,NA,NA,NA,Service Charge,1107.01 Cash:Old St. Francis Xavier Accounts:St. Francis Xavier Ckg #0396,332,124.79,32774.45
,,,1/19/2021,Check,8977,ACH,Analysis activity,824,NA,1101.10 Cash:Saints JFX Oper. Acct. #2264:Checking Available,691,289.66,33064.11
,,,2/2/2021,Check,8981,ACH,Bank Card,341,NA,1101.10 Cash:Saints JFX Oper. Acct. #2264:Checking Available,691,5003.68,38067.79
,,,2/2/2021,Check,8980,ACH,First Fund,340,NA,1101.10 Cash:Saints JFX Oper. Acct. #2264:Checking Available,691,277,38344.79
,,,2/19/2021,Check,8982,ACH,Analysis activity,824,NA,1101.10 Cash:Saints JFX Oper. Acct. #2264:Checking Available,691,158.88,38503.67
4159 Other Administrative Expense,420,,,,,,,,,,,,
,,73.5,,,,,,,,,,,
4200 Transportation,162,,,,,,,,,,,,
4201 Local Travel/Reimbursement,NA,,,,,,,,,,,,
,,60.89,,,,,,,,,,,
4250 Food Service & Meals,56,,,,,,,,,,,,
4252 Food/Groceries,NA,,,,,,,,,,,,
,,11547.12,,,,,,,,,,,
,,,1/25/2021,Bill,8415,Jan statement,Albertsons/Safeway,156,NA,2000 Accounts Payable,217,908.65,12455.77
,,,1/27/2021,Bill,8436,2042347,"Schaefer's Wines, Foods & Spirits",56,NA,2000 Accounts Payable,217,880.84,13336.61
,,,2/9/2021,Bill,8454,RR h2o and more,Wayne Watts,241,NA,2000 Accounts Payable,217,306.69,13643.3
,,,2/23/2021,Bill,8539,Feb statement,Albertsons/Safeway,156,NA,2000 Accounts Payable,217,556.05,14199.35
,,,3/8/2021,Bill,8596,RR Supplies/Snacks,Jennifer Miller,262,NA,2000 Accounts Payable,217,15,14214.35
,,,3/10/2021,Bill,8633,RR,Wayne Watts,241,NA,2000 Accounts Payable,217,183.44,14397.79
,,,3/10/2021,Bill,8644,2048127/2049612,"Schaefer's Wines, Foods & Spirits",56,NA,2000 Accounts Payable,217,59.03,14456.82
4253 Meal Allowance,57,,,,,,,,,,,,
,,2961.06,,,,,,,,,,,
,,,1/12/2021,Bill,8073,MA December,Daniel Mayall,85,NA,2000 Accounts Payable,217,63,3024.06
,,,2/9/2021,Bill,8453,MA January 2021,Daniel Mayall,85,NA,2000 Accounts Payable,217,147,3171.06
,,,3/8/2021,Bill,8619,MA Feb 2021,Daniel Mayall,85,NA,2000 Accounts Payable,217,63,3234.06
,,,3/10/2021,Bill,8647,Jan & Feb MA,Edward Harnett,121,NA,2000 Accounts Payable,217,672,3906.06
4254 Catering,58,,,,,,,,,,,,
,,968.71,,,,,,,,,,,
4400 Telephone,60,,,,,,,,,,,,
,,6269.91,,,,,,,,,,,
,,,1/12/2021,Bill,8066,2447978501,AT&T SJC 395,25,NA,2000 Accounts Payable,217,93.78,6363.69
,,,1/12/2021,Bill,8068,9869406380,Verizon Wireless,118,NA,2000 Accounts Payable,217,44.05,6407.74
,,,1/12/2021,Bill,8068,9869406380,Verizon Wireless,118,NA,2000 Accounts Payable,217,44.05,6451.79
,,,1/12/2021,Bill,8067,Nov 20 - Dec 19,AT&T SJC YFF 2253,448,NA,2000 Accounts Payable,217,74.62,6526.41
,,,1/12/2021,Bill,8064,2454978502,AT&T SFX ALL 5570 631,169,NA,2000 Accounts Payable,217,399.46,6925.87
,,,1/12/2021,Bill,8063,2469878507,AT&T SJS,235,NA,2000 Accounts Payable,217,163.62,7089.49
,,,1/12/2021,Bill,8064,2454978502,AT&T SFX ALL 5570 631,169,NA,2000 Accounts Payable,217,399.46,7488.95
,,,1/13/2021,Bill,8398,7572301,AT&T Messaging SFX CH,71,NA,2000 Accounts Payable,217,14.95,7503.9
,,,1/25/2021,Bill,8433,9871519103,Verizon Wireless,118,NA,2000 Accounts Payable,217,46.62,7550.52
,,,1/25/2021,Bill,8433,9871519103,Verizon Wireless,118,NA,2000 Accounts Payable,217,46.63,7597.15
,,,1/25/2021,Bill,8417,5338499503,AT&T SJC 395,25,NA,2000 Accounts Payable,217,188.83,7785.98
,,,1/25/2021,Bill,8416,5350499507,AT&T SJS,235,NA,2000 Accounts Payable,217,334.65,8120.63
,,,1/27/2021,Bill,8434,5345499504,AT&T SFX ALL 5570 631,169,NA,2000 Accounts Payable,217,416.23,8536.86
,,,1/27/2021,Bill,8434,5345499504,AT&T SFX ALL 5570 631,169,NA,2000 Accounts Payable,217,416.23,8953.09
,,,1/29/2021,Bill,7136,Dec - Jan statement,AT&T SJC YFF 2253,448,NA,2000 Accounts Payable,217,70.93,9024.02
,,,2/10/2021,Bill,8480,7577950,AT&T Messaging SFX CH,71,NA,2000 Accounts Payable,217,14.95,9038.97
,,,2/23/2021,Bill,8546,5989801602,AT&T SFX ALL 5570 631,169,NA,2000 Accounts Payable,217,412.53,9451.5
,,,2/23/2021,Bill,8550,5972901609,AT&T SJC 395,25,NA,2000 Accounts Payable,217,5.42,9456.92
,,,2/23/2021,Bill,8535,5994801605,AT&T SJS,235,NA,2000 Accounts Payable,217,9.97,9466.89
,,,2/23/2021,Bill,8546,5989801602,AT&T SFX ALL 5570 631,169,NA,2000 Accounts Payable,217,412.53,9879.42
,,,3/8/2021,Bill,8604,Jan 20- Feb 19,AT&T SJC YFF 2253,448,NA,2000 Accounts Payable,217,82.65,9962.07
,,,3/8/2021,Bill,8605,9873632673,Verizon Wireless,118,NA,2000 Accounts Payable,217,44.13,10006.2
,,,3/8/2021,Bill,8605,9873632673,Verizon Wireless,118,NA,2000 Accounts Payable,217,44.12,10050.32
4410 Heating Fuel,61,,,,,,,,,,,,
,,4861.43,,,,,,,,,,,
,,,1/11/2021,Bill,8374,11/26 - 12/27,Nicor SJ Convent,12,NA,2000 Accounts Payable,217,907.46,5768.89
,,,2/8/2021,Bill,7144,3099643,Constellation BG91706,130,Sep-20,2000 Accounts Payable,217,189.62,5958.51
,,,2/8/2021,Bill,7143,3099828,Constellation BG142404,128,Sep-20,2000 Accounts Payable,217,216.36,6174.87
,,,2/8/2021,Bill,7142,3105714,Constellation BG92634,91,Sept - Nov 2020,2000 Accounts Payable,217,3105.34,9280.21
,,,2/8/2021,Bill,7141,3105710,Constellation BG92628,90,Sept - Nov 2020,2000 Accounts Payable,217,3747.87,13028.08
,,,2/9/2021,Bill,7164,Dec - Jan statement,Nicor SJ Convent,12,NA,2000 Accounts Payable,217,981.85,14009.93
,,,2/22/2021,Bill,8485,3105662,Constellation BG91705,129,NA,2000 Accounts Payable,217,850.11,14860.04
,,,2/22/2021,Bill,8487,3105847,Constellation BG142404,128,NA,2000 Accounts Payable,217,1284.43,16144.47
,,,2/22/2021,Bill,8507,12/29 - 2/9,Nicor SFX Sch,168,NA,2000 Accounts Payable,217,220.67,16365.14
,,,2/22/2021,Bill,8498,3105661,Constellation BG91704,127,NA,2000 Accounts Payable,217,1533.69,17898.83
,,,2/22/2021,Bill,8493,3104370,Constellation BG91704,127,NA,2000 Accounts Payable,217,1363.09,19261.92
,,,2/22/2021,Bill,8486,3105663,Constellation BG91706,130,NA,2000 Accounts Payable,217,1238.86,20500.78
,,,3/8/2021,Bill,8610,3122257,Constellation BG92634,91,NA,2000 Accounts Payable,217,2391.37,22892.15
,,,3/8/2021,Bill,8607,1/28 - 2/25,Nicor SJ Convent,12,NA,2000 Accounts Payable,217,1040.9,23933.05
,,,3/8/2021,Bill,8626,3122205,Constellation BG91705,129,NA,2000 Accounts Payable,217,666.99,24600.04
,,,3/8/2021,Bill,8612,11/25-12/29,Nicor SFX Sch,168,NA,2000 Accounts Payable,217,45.02,24645.06
,,,3/8/2021,Bill,8616,3122253,Constellation BG92628,90,NA,2000 Accounts Payable,217,3572.47,28217.53
,,,3/8/2021,Bill,8627,3122206,Constellation BG91706,130,NA,2000 Accounts Payable,217,777.46,28994.99
,,,3/8/2021,Bill,8625,3122391,Constellation BG142404,128,NA,2000 Accounts Payable,217,679.64,29674.63
,,,3/8/2021,Bill,8599,3122204,Constellation BG91704,127,NA,2000 Accounts Payable,217,2362.92,32037.55
4420 Electricity,62,,,,,,,,,,,,
,,33710.06,,,,,,,,,,,
,,,1/11/2021,Bill,6578,3784941,Engie Resources Convent SJ,112,10/26/20 - 11/24/20 billing difference,2000 Accounts Payable,217,3.65,33713.71
,,,1/11/2021,Bill,6578,3784941,Engie Resources Convent SJ,112,9/24/20 - 10/26/20 billing difference,2000 Accounts Payable,217,6.21,33719.92
,,,1/11/2021,Bill,6577,3784918,Engie Resources SJ Campus,111,9/24/20 - 10/26/20 billing difference,2000 Accounts Payable,217,81.09,33801.01
,,,1/11/2021,Bill,6577,3784918,Engie Resources SJ Campus,111,10/26/20 - 11/24/20 billing difference,2000 Accounts Payable,217,55.85,33856.86
,,,1/12/2021,Bill,8082,3799341,Engie Resources SJ Campus,111,NA,2000 Accounts Payable,217,890.79,34747.65
,,,1/12/2021,Bill,8081,3799271,Engie Resources Convent SJ,112,NA,2000 Accounts Payable,217,123.7,34871.35
,,,1/12/2021,Bill,8082,3799341,Engie Resources SJ Campus,111,NA,2000 Accounts Payable,217,890.8,35762.15
,,,1/13/2021,Bill,8404,3784858,Engie SFX,253,Oct - Nov difference in bill,2000 Accounts Payable,217,114.07,35876.22
,,,1/13/2021,Bill,8404,3784858,Engie SFX,253,Sept - Oct difference in bill,2000 Accounts Payable,217,162.62,36038.84
,,,1/25/2021,Bill,8425,3798378,Engie SFX,253,Jan-21,2000 Accounts Payable,217,4421.88,40460.72
,,,1/25/2021,Bill,8425,3798378,Engie SFX,253,Nov - Dec 2020,2000 Accounts Payable,217,4273.37,44734.09
,,,3/10/2021,Bill,7191,3982813,Engie Resources Convent SJ,112,NA,2000 Accounts Payable,217,250.52,44984.61
,,,3/10/2021,Bill,7193,3982794,Engie SFX,253,NA,2000 Accounts Payable,217,1934.64,46919.25
,,,3/10/2021,Bill,7192,3982838,Engie Resources SJ Campus,111,NA,2000 Accounts Payable,217,799.41,47718.66
,,,3/10/2021,Bill,7192,3982838,Engie Resources SJ Campus,111,NA,2000 Accounts Payable,217,799.41,48518.07
,,,3/10/2021,Bill,7193,3982794,Engie SFX,253,NA,2000 Accounts Payable,217,1934.64,50452.71
4430 Other Utilities,63,,,,,,,,,,,,
4431 Water/Sewer,NA,,,,,,,,,,,,
,,13314.93,,,,,,,,,,,
,,,1/11/2021,Bill,6582,638413,Village of Wilmette SJ Annex 330900,830,NA,2000 Accounts Payable,217,820.5,14135.43
,,,1/12/2021,Bill,8072,271872020B000,Metropolitan Water Reclamation District,518,NA,2000 Accounts Payable,217,674.79,14810.22
,,,1/12/2021,Bill,8074,271962020B000,Metropolitan Water Reclamation District,518,NA,2000 Accounts Payable,217,324.1,15134.32
,,,2/10/2021,Bill,8475,642076,Village of Wilmette SFX CH 992100,225,NA,2000 Accounts Payable,217,357.09,15491.41
,,,2/10/2021,Bill,8476,641465,Village of Wilmette SFX Rectory 201110,226,NA,2000 Accounts Payable,217,700.05,16191.46
,,,2/10/2021,Bill,8477,641264,Village of Wilmette SFX Conv 190780,227,NA,2000 Accounts Payable,217,354.02,16545.48
,,,2/22/2021,Bill,8494,642075,Village of Wilmette SFX SCH 992090,228,NA,2000 Accounts Payable,217,175.61,16721.09
,,,2/22/2021,Bill,8495,641466,Village of Wilmette SFX SCH 201120,476,NA,2000 Accounts Payable,217,478.98,17200.07
4432 Scavenger Service,64,,,,,,,,,,,,
,,5392.8,,,,,,,,,,,
,,,1/12/2021,Bill,8377,T40002536325,Advanced Disposal SJ CH,108,NA,2000 Accounts Payable,217,429.81,5822.61
,,,1/12/2021,Bill,8378,T40002535551,Advanced Disposal SFX Sch,60,NA,2000 Accounts Payable,217,457.03,6279.64
,,,1/13/2021,Bill,8401,T40002530908,Advanced Disposal SFX CH,59,NA,2000 Accounts Payable,217,157.05,6436.69
,,,2/8/2021,Bill,7137,T40002552530,Advanced Disposal SFX Sch,60,NA,2000 Accounts Payable,217,457.03,6893.72
,,,2/8/2021,Bill,7138,T40002552731,Advanced Disposal SJ CH,108,NA,2000 Accounts Payable,217,429.81,7323.53
,,,3/10/2021,Bill,7205,T40002564538,Advanced Disposal SJ CH,108,NA,2000 Accounts Payable,217,214.9,7538.43
,,,3/10/2021,Bill,7205,T40002564538,Advanced Disposal SJ CH,108,NA,2000 Accounts Payable,217,214.91,7753.34
,,,3/10/2021,Bill,7204,T40002564360,Advanced Disposal SFX Sch,60,NA,2000 Accounts Payable,217,457.03,8210.37
4433 Cable/Dish Services,65,,,,,,,,,,,,
,,2706.24,,,,,,,,,,,
,,,1/11/2021,Bill,6586,Jan 1 - Feb 1 2021,Comcast Business (TV) SFXS 1576,57,NA,2000 Accounts Payable,217,5.04,2711.28
,,,1/12/2021,Bill,8062,Jan 2021 statement,Comcast SFX Rectory 2307,170,NA,2000 Accounts Payable,217,232.75,2944.03
,,,2/9/2021,Bill,7175,Jan statement,Comcast SFX Rectory 2307,170,NA,2000 Accounts Payable,217,238.05,3182.08
,,,2/22/2021,Bill,8492,February statement,Comcast Business (TV) SFXS 1576,57,NA,2000 Accounts Payable,217,42.56,3224.64
,,,3/8/2021,Bill,8628,March,Comcast SFX Rectory 2307,170,NA,2000 Accounts Payable,217,238.01,3462.65
,,,3/8/2021,Bill,8600,Mar - Apr,Comcast Business (TV) SFXS 1576,57,NA,2000 Accounts Payable,217,85.12,3547.77
4434 Internet/Computer Telecom Costs,66,,,,,,,,,,,,
,,5486.78,,,,,,,,,,,
,,,1/11/2021,Bill,8376,19-482-251,TelAssist,137,NA,2000 Accounts Payable,217,94.92,5581.7
,,,1/12/2021,Bill,8079,113790861,Comcast Business (Internet) SJS 5239,851,NA,2000 Accounts Payable,217,293.35,5875.05
,,,1/25/2021,Bill,8431,19-642-471,TelAssist,137,NA,2000 Accounts Payable,217,99.34,5974.39
,,,1/27/2021,Bill,8435,Jan 20 - Feb 19,Comcast SFX Office 2331,142,NA,2000 Accounts Payable,217,130.61,6105
,,,1/27/2021,Bill,8444,113790791,Comcast Business (Internet) SFXS 5692,850,NA,2000 Accounts Payable,217,224.9,6329.9
,,,2/11/2021,Bill,8481,115620077,Comcast Business (Internet) SJS 5239,851,NA,2000 Accounts Payable,217,293.35,6623.25
,,,2/22/2021,Bill,8489,115620007,Comcast Business (Internet) SFXS 5692,850,March,2000 Accounts Payable,217,224.9,6848.15
,,,2/22/2021,Bill,8489,115620007,Comcast Business (Internet) SFXS 5692,850,February,2000 Accounts Payable,217,224.9,7073.05
,,,2/23/2021,Bill,8549,19-988-331,TelAssist,137,NA,2000 Accounts Payable,217,100.32,7173.37
,,,3/8/2021,Bill,8615,Feb 20 - Mar 19,Comcast SFX Office 2331,142,NA,2000 Accounts Payable,217,130.61,7303.98
4450 Maintenance & Building Repairs,67,,,,,,,,,,,,
,,334,,,,,,,,,,,
4451 Security,68,,,,,,,,,,,,
,,20825.49,,,,,,,,,,,
,,,1/11/2021,Bill,6591,9502,Wilshore Electric LLC,872,fire alarm inspection,2000 Accounts Payable,217,644,21469.49
,,,1/11/2021,Bill,6588,746066,Anderson Lock,185,NA,2000 Accounts Payable,217,16.36,21485.85
,,,1/25/2021,Bill,8412,1056874,Anderson Lock,185,NA,2000 Accounts Payable,217,16.36,21502.21
,,,2/8/2021,Bill,7151,1058134,Anderson Lock,185,NA,2000 Accounts Payable,217,114,21616.21
,,,2/9/2021,Bill,8452,RR key/planner,John Hopkins,101,NA,2000 Accounts Payable,217,12.45,21628.66
,,,2/9/2021,Bill,7174,35392206,Johnson Controls Security Solutions SJS,588,1/26 install,2000 Accounts Payable,217,519.79,22148.45
,,,2/11/2021,Bill,8482,35476952,Johnson Controls SJconvent 2639AD,460,NA,2000 Accounts Payable,217,215.91,22364.36
,,,2/11/2021,Bill,8483,35476959,Johnson Controls Security Solutions SJC,589,NA,2000 Accounts Payable,217,892.69,23257.05
,,,2/11/2021,Bill,8484,35476951,Johnson Controls Security Solutions SJS,588,NA,2000 Accounts Payable,217,892.69,24149.74
,,,3/8/2021,Bill,8617,35476961,Johnson Controls SFX SCH 7898,473,NA,2000 Accounts Payable,217,215.91,24365.65
,,,3/8/2021,Bill,8618,35476946,Johnson Controls SFX CH 7578,474,NA,2000 Accounts Payable,217,249.35,24615
,,,3/8/2021,Bill,8620,1060078,Anderson Lock,185,NA,2000 Accounts Payable,217,114,24729
4452 Ground Services,69,,,,,,,,,,,,
,,43515.14,,,,,,,,,,,
,,,1/12/2021,Bill,8076,37,Ron's Artic Snowplowing,304,NA,2000 Accounts Payable,217,2166.25,45681.39
,,,1/12/2021,Bill,8076,37,Ron's Artic Snowplowing,304,NA,2000 Accounts Payable,217,4175,49856.39
,,,1/25/2021,Bill,8410,41,Ron's Artic Snowplowing,304,NA,2000 Accounts Payable,217,2166.25,52022.64
,,,1/25/2021,Bill,8410,41,Ron's Artic Snowplowing,304,NA,2000 Accounts Payable,217,4175,56197.64
,,,2/8/2021,Bill,7153,47,Ron's Artic Snowplowing,304,approved 6 hr snow transfer from SFX to SJ,2000 Accounts Payable,217,1800,57997.64
,,,2/8/2021,Bill,7153,47,Ron's Artic Snowplowing,304,NA,2000 Accounts Payable,217,2087.5,60085.14
,,,2/8/2021,Bill,7153,47,Ron's Artic Snowplowing,304,NA,2000 Accounts Payable,217,2087.5,62172.64
,,,2/8/2021,Bill,7153,47,Ron's Artic Snowplowing,304,NA,2000 Accounts Payable,217,1083.13,63255.77
,,,2/8/2021,Bill,7153,47,Ron's Artic Snowplowing,304,NA,2000 Accounts Payable,217,1083.12,64338.89
4453 Ground Supplies,70,,,,,,,,,,,,
,,833.68,,,,,,,,,,,
,,,1/27/2021,Bill,8440,11321,Impressions In Stone,236,NA,2000 Accounts Payable,217,177.9,1011.58
,,,2/8/2021,Bill,7155,597910728,Home Depot Pro SFX,480,ice melt,2000 Accounts Payable,217,343.8,1355.38
,,,2/8/2021,Bill,7154,597910736,Home Depot Pro SFX,480,ice melt,2000 Accounts Payable,217,171.9,1527.28
,,,2/8/2021,Bill,7154,597910736,Home Depot Pro SFX,480,ice melt,2000 Accounts Payable,217,171.9,1699.18
4454 Building Services,71,,,,,,,,,,,,
,,33463.95,,,,,,,,,,,
,,,1/12/2021,Bill,8070,40727,Precision,93,NA,2000 Accounts Payable,217,1491,34954.95
,,,2/8/2021,Bill,7146,SM2092-2,Martin Peterson Company Inc.,353,contract payment,2000 Accounts Payable,217,1809,36763.95
,,,2/8/2021,Bill,7146,SM2092-2,Martin Peterson Company Inc.,353,contract payment,2000 Accounts Payable,217,1809,38572.95
,,,2/8/2021,Bill,7145,SM20903-4,Martin Peterson Company Inc.,353,contract payment,2000 Accounts Payable,217,1896.5,40469.45
,,,2/9/2021,Bill,8461,SM20904-4,Martin Peterson Company Inc.,353,NA,2000 Accounts Payable,217,4461.5,44930.95
,,,2/22/2021,Bill,8528,13805,Meco Electric Company Inc.,147,NA,2000 Accounts Payable,217,531,45461.95
4455 Repairs to Buildings,115,,,,,,,,,,,,
,,53132.73,,,,,,,,,,,
,,,1/13/2021,Bill,8402,9511,Wilshore Electric LLC,872,NA,2000 Accounts Payable,217,1740,54872.73
,,,1/25/2021,Bill,8414,SW20927,Martin Peterson Company Inc.,353,NA,2000 Accounts Payable,217,8140,63012.73
,,,1/25/2021,Bill,8413,SW20926,Martin Peterson Company Inc.,353,NA,2000 Accounts Payable,217,3050,66062.73
,,,2/8/2021,Bill,7149,S33719,Martin Peterson Company Inc.,353,check sub pump in PO,2000 Accounts Payable,217,195,66257.73
,,,2/8/2021,Bill,7148,S33417,Martin Peterson Company Inc.,353,Boiler leaking,2000 Accounts Payable,217,2549.51,68807.24
,,,2/8/2021,Bill,7147,SW21901,Martin Peterson Company Inc.,353,PO sump pump replacement,2000 Accounts Payable,217,2440,71247.24
,,,2/9/2021,Bill,7166,JC13311,F.J. Kerrigan Plumbing Co. Inc,87,NA,2000 Accounts Payable,217,3111.04,74358.28
,,,2/9/2021,Bill,7167,JC13317,F.J. Kerrigan Plumbing Co. Inc,87,NA,2000 Accounts Payable,217,4095.86,78454.14
,,,2/10/2021,Bill,8479,9540,Wilshore Electric LLC,872,NA,2000 Accounts Payable,217,1740,80194.14
,,,2/23/2021,Bill,8538,5834,Shephard Plumbing,154,NA,2000 Accounts Payable,217,366,80560.14
,,,2/25/2021,Bill,8551,1401808,Cecil Painting,164,NA,2000 Accounts Payable,217,3600,84160.14
,,,3/2/2021,Bill,8552,1401811,Cecil Painting,164,NA,2000 Accounts Payable,217,600,84760.14
,,,3/8/2021,Bill,8631,5879,Shephard Plumbing,154,NA,2000 Accounts Payable,217,475,85235.14
,,,3/10/2021,Bill,8632,JC13187 adj,F.J. Kerrigan Plumbing Co. Inc,87,NA,2000 Accounts Payable,217,1008.1,86243.24
4456 Equipment Services,116,,,,,,,,,,,,
,,13321.56,,,,,,,,,,,
,,,1/25/2021,Bill,8407,IN00409279,Fox Valley Fire and Safety,269,NA,2000 Accounts Payable,217,337,13658.56
,,,1/25/2021,Bill,8424,13679,Berghaus,270,NA,2000 Accounts Payable,217,215.65,13874.21
,,,2/8/2021,Bill,7152,SFXC 2071,Integrity Systems,553,replace AMP at SFX,2000 Accounts Payable,217,469,14343.21
,,,2/23/2021,Bill,8542,RR repair,Joseph D'Arco,45,NA,2000 Accounts Payable,217,246,14589.21
,,,3/8/2021,Bill,8629,9641781,Illinois Office of the State Fire Marshal,508,NA,2000 Accounts Payable,217,95,14684.21
4457 Equipment Rental,117,,,,,,,,,,,,
,,-182.18,,,,,,,,,,,
4459 Janitorial Supplies,118,,,,,,,,,,,,
,,25759.36,,,,,,,,,,,
,,,1/11/2021,Bill,6581,8060733105,Staples SJ,92,cleaning supplies,2000 Accounts Payable,217,133.86,25893.22
,,,1/11/2021,Bill,6583,1738171-03,"Kranz, Inc",415,sanitizer/hand towel roll,2000 Accounts Payable,217,355.44,26248.66
,,,1/11/2021,Bill,6581,8060733105,Staples SJ,92,cleaning supplies,2000 Accounts Payable,217,10.34,26259
,,,1/11/2021,Bill,6581,8060733105,Staples SJ,92,toilet paper,2000 Accounts Payable,217,47.3,26306.3
,,,1/12/2021,Bill,8069,40611,Precision,93,NA,2000 Accounts Payable,217,376,26682.3
,,,1/13/2021,Bill,8403,RR supplies,Janina Jakucewicz,138,NA,2000 Accounts Payable,217,229.08,26911.38
,,,1/25/2021,Bill,8418,10573050-00,"Active Electrical Supply Co., Inc",107,NA,2000 Accounts Payable,217,21.48,26932.86
,,,1/27/2021,Bill,8448,141569/86,Millen Hardware,155,NA,2000 Accounts Payable,217,513.45,27446.31
,,,2/9/2021,Bill,7171,B134985,North American,184,NA,2000 Accounts Payable,217,125.19,27571.5
,,,2/9/2021,Bill,7179,B049060,North American,184,NA,2000 Accounts Payable,217,541.02,28112.52
,,,2/10/2021,Bill,8470,4846960-0,Warehouse Direct SJ,82,NA,2000 Accounts Payable,217,157.99,28270.51
,,,2/10/2021,Bill,8472,1742892-00,"Kranz, Inc",415,NA,2000 Accounts Payable,217,1509.53,29780.04
,,,2/10/2021,Bill,8473,1738171-04,"Kranz, Inc",415,NA,2000 Accounts Payable,217,450.44,30230.48
,,,2/10/2021,Bill,8478,feb acct balance,Millen Hardware,155,NA,2000 Accounts Payable,217,363.78,30594.26
,,,2/22/2021,Bill,8515,10573050-01,"Active Electrical Supply Co., Inc",107,NA,2000 Accounts Payable,217,24.27,30618.53
,,,2/23/2021,Vendor Credit,8541,1743151-00,"Kranz, Inc",415,NA,2000 Accounts Payable,217,-456.28,30162.25
,,,3/8/2021,Bill,8598,RR supplies,Janina Jakucewicz,138,NA,2000 Accounts Payable,217,186.42,30348.67
,,,3/10/2021,Bill,8634,2/28 end statement,Millen Hardware,155,NA,2000 Accounts Payable,217,248.54,30597.21
4600 Interest Expense,378,,,,,,,,,,,,
4601 Interest Expense Oper. Loans,NA,,,,,,,,,,,,
,,3666.88,,,,,,,,,,,
,,,1/29/2021,Bill,8591,FC-0017962,Catholic Bishop of Chicago (BillingSJInt),549,NA,2000 Accounts Payable,217,237.91,3904.79
,,,1/29/2021,Bill,8593,FC-0017835,Catholic Bishop of Chicago (BillingSJInt),549,NA,2000 Accounts Payable,217,322.61,4227.4
,,,2/26/2021,Bill,8592,FC-0018193,Catholic Bishop of Chicago (BillingSJInt),549,NA,2000 Accounts Payable,217,229.71,4457.11
,,,2/26/2021,Bill,8594,FC-0018067,Catholic Bishop of Chicago (BillingSJInt),549,NA,2000 Accounts Payable,217,311.49,4768.6
4650 Altar & Liturgical Supplies,120,,,,,,,,,,,,
,,141.42,,,,,,,,,,,
4651 Hosts and Wine,121,,,,,,,,,,,,
,,668.41,,,,,,,,,,,
,,,2/22/2021,Bill,8509,0308012-IN,Benedictine Sisters Altar Bread,61,NA,2000 Accounts Payable,217,292.08,960.49
4653 Candles,123,,,,,,,,,,,,
,,904.7,,,,,,,,,,,
,,,1/11/2021,Bill,6580,107188,Monk's WIne and Candles SSJFX,65,NA,2000 Accounts Payable,217,98.8,1003.5
,,,2/8/2021,Bill,7159,2021-1213,Monk's WIne and Candles SSJFX,65,paschal candle,2000 Accounts Payable,217,391.4,1394.9
,,,2/8/2021,Bill,7157,2021-1212,Monk's WIne and Candles SSJFX,65,NA,2000 Accounts Payable,217,23,1417.9
,,,2/8/2021,Bill,7158,107326,Monk's WIne and Candles SSJFX,65,NA,2000 Accounts Payable,217,368.2,1786.1
4656 Music Books,126,,,,,,,,,,,,
,,28.84,,,,,,,,,,,
,,,1/12/2021,Bill,8379,RR spirit/psalms,John Hopkins,101,NA,2000 Accounts Payable,217,55.67,84.51
,,,1/12/2021,Bill,8380,RR music/office exp,John Hopkins,101,NA,2000 Accounts Payable,217,28.27,112.78
,,,1/12/2021,Bill,8075,RR reprint from 12/7,John Hopkins,101,wkly psalms,2000 Accounts Payable,217,68.39,181.17
,,,1/25/2021,Bill,8426,94146049/94166105,OCP,475,NA,2000 Accounts Payable,217,283.32,464.49
4657 Liturgical Publications,129,,,,,,,,,,,,
,,1391.75,,,,,,,,,,,
,,,2/8/2021,Bill,7150,39459,Liguori Publications,585,NA,2000 Accounts Payable,217,55,1446.75
,,,2/23/2021,Bill,8547,RR gc and music,John Hopkins,101,NA,2000 Accounts Payable,217,18.83,1465.58
4659 Flowers,130,,,,,,,,,,,,
,,3194.85,,,,,,,,,,,
,,,1/13/2021,Bill,8400,271821,Morning Glory Flower Shop,55,NA,2000 Accounts Payable,217,89,3283.85
4660 Other Liturgical Costs,127,,,,,,,,,,,,
,,784.66,,,,,,,,,,,
,,,1/11/2021,Bill,6592,705624-01,Watra Church Goods,350,blk shirt,2000 Accounts Payable,217,11.5,796.16
,,,1/11/2021,Bill,6569,107211,Monk's WIne and Candles SSJFX,65,NA,2000 Accounts Payable,217,93.56,889.72
,,,2/8/2021,Bill,7159,2021-1213,Monk's WIne and Candles SSJFX,65,palms,2000 Accounts Payable,217,194.25,1083.97
,,,2/8/2021,Bill,7157,2021-1212,Monk's WIne and Candles SSJFX,65,Palms,2000 Accounts Payable,217,233.75,1317.72
4700 Furnishings & Equipment,132,,,,,,,,,,,,
4701 Admin Furnishings/Equip,NA,,,,,,,,,,,,
,,20761.74,,,,,,,,,,,
,,,1/11/2021,Bill,6590,22295498,Canon SFX,524,NA,2000 Accounts Payable,217,234,20995.74
,,,1/12/2021,Bill,8083,22295612,Canon,258,NA,2000 Accounts Payable,217,32.66,21028.4
,,,1/12/2021,Bill,8083,22295612,Canon,258,NA,2000 Accounts Payable,217,990.81,22019.21
,,,1/12/2021,Bill,8083,22295612,Canon,258,NA,2000 Accounts Payable,217,23.07,22042.28
,,,1/12/2021,Bill,8083,22295612,Canon,258,NA,2000 Accounts Payable,217,213.36,22255.64
,,,1/12/2021,Bill,8083,22295612,Canon,258,NA,2000 Accounts Payable,217,250.95,22506.59
,,,1/12/2021,Bill,8083,22295612,Canon,258,NA,2000 Accounts Payable,217,11.15,22517.74
,,,1/25/2021,Bill,8409,3702,Sparks Interior LTD,877,school shades,2000 Accounts Payable,217,899,23416.74
,,,1/25/2021,Bill,8423,RI104746791,FP Mailing Solutions,114,NA,2000 Accounts Payable,217,95.34,23512.08
,,,1/25/2021,Bill,8429,RR Mixer for loft,Jonathan Metzinger,438,NA,2000 Accounts Payable,217,209.99,23722.07
,,,1/27/2021,Bill,8451,3104503233,Pitney Bowes SFXS 0015503825,488,NA,2000 Accounts Payable,217,111.6,23833.67
,,,2/8/2021,Bill,7156,26185479,Canon SFX,524,color copier rental,2000 Accounts Payable,217,234,24067.67
,,,2/8/2021,Bill,7139,26185504,Canon,258,NA,2000 Accounts Payable,217,250.95,24318.62
,,,2/8/2021,Bill,7139,26185504,Canon,258,NA,2000 Accounts Payable,217,11.15,24329.77
,,,2/8/2021,Bill,7139,26185504,Canon,258,NA,2000 Accounts Payable,217,213.36,24543.13
,,,2/8/2021,Bill,7139,26185504,Canon,258,NA,2000 Accounts Payable,217,990.81,25533.94
,,,2/8/2021,Bill,7139,26185504,Canon,258,NA,2000 Accounts Payable,217,23.07,25557.01
,,,2/8/2021,Bill,7139,26185504,Canon,258,NA,2000 Accounts Payable,217,32.66,25589.67
,,,3/8/2021,Bill,8630,26344154,Canon SFX,524,NA,2000 Accounts Payable,217,234,25823.67
,,,3/8/2021,Bill,8621,RI104799347,FP Mailing Solutions SJS,381,NA,2000 Accounts Payable,217,133.06,25956.73
,,,3/10/2021,Bill,7207,26344175,Canon,258,NA,2000 Accounts Payable,217,990.81,26947.54
,,,3/10/2021,Bill,7207,26344175,Canon,258,NA,2000 Accounts Payable,217,213.36,27160.9
,,,3/10/2021,Bill,7207,26344175,Canon,258,NA,2000 Accounts Payable,217,32.66,27193.56
,,,3/10/2021,Bill,7207,26344175,Canon,258,NA,2000 Accounts Payable,217,23.07,27216.63
,,,3/10/2021,Bill,8650,145561,GO Technology Group Inc.,64,NA,2000 Accounts Payable,217,200,27416.63
,,,3/10/2021,Bill,7186,RI104808702,FP Mailing Solutions,114,NA,2000 Accounts Payable,217,86.85,27503.48
,,,3/10/2021,Bill,7207,26344175,Canon,258,NA,2000 Accounts Payable,217,11.15,27514.63
,,,3/10/2021,Bill,7207,26344175,Canon,258,NA,2000 Accounts Payable,217,250.95,27765.58
4702 Instructional Furnishings/Equip,133,,,,,,,,,,,,
,,177079.59,,,,,,,,,,,
,,,1/11/2021,Bill,8370,145403,GO Technology Group Inc.,64,NA,2000 Accounts Payable,217,5345,182424.59
,,,1/11/2021,Bill,6571,AE12053296,Apple Inc.,846,NA,2000 Accounts Payable,217,5310,187734.59
,,,1/27/2021,Bill,8439,RR camera/elearning,Kit Kalpin,881,NA,2000 Accounts Payable,217,22.5,187757.09
,,,2/9/2021,Bill,8459,145481,GO Technology Group Inc.,64,NA,2000 Accounts Payable,217,184.5,187941.59
,,,2/22/2021,Bill,8500,SFX1042021,Worthington Direct,382,NA,2000 Accounts Payable,217,1264.58,189206.17
4703 Maintenance Furnishings/Equip,134,,,,,,,,,,,,
,,4633.76,,,,,,,,,,,
4750 Archdiocesan Assessment,253,,,,,,,,,,,,
4751 Archhdiocesean Assesment,NA,,,,,,,,,,,,
,,118525.44,,,,,,,,,,,
,,,1/1/2021,Bill,8384,AR00174984,Catholic Bishop of Chicago (BillingSSJFX),359,NA,2000 Accounts Payable,217,19754.24,138279.68
,,,2/1/2021,Bill,8568,AR00175792,Catholic Bishop of Chicago (BillingSSJFX),359,NA,2000 Accounts Payable,217,19754.24,158033.92
,,,3/1/2021,Bill,8571,AR00176601,Catholic Bishop of Chicago (BillingSSJFX),359,NA,2000 Accounts Payable,217,19754.24,177788.16
"4752 Lease, Lic & Rental Arch Assess",254,,,,,,,,,,,,
,,2781,,,,,,,,,,,
,,,1/1/2021,Bill,8385,AR00175239,Catholic Bishop of Chicago (BillingSSJFX),359,NA,2000 Accounts Payable,217,463.5,3244.5
,,,2/1/2021,Bill,8569,AR00176048,Catholic Bishop of Chicago (BillingSSJFX),359,NA,2000 Accounts Payable,217,463.5,3708
,,,3/1/2021,Bill,8572,AR00176857,Catholic Bishop of Chicago (BillingSSJFX),359,NA,2000 Accounts Payable,217,463.5,4171.5
4760 PRMAA Assessment,145,,,,,,,,,,,,
,,41483.88,,,,,,,,,,,
,,,1/1/2021,Bill,8386,AR00175481,Catholic Bishop of Chicago (BillingSSJFX),359,NA,2000 Accounts Payable,217,6913.98,48397.86
,,,2/1/2021,Bill,8570,AR00176289,Catholic Bishop of Chicago (BillingSSJFX),359,NA,2000 Accounts Payable,217,6913.98,55311.84
,,,3/1/2021,Bill,8573,AR00177098,Catholic Bishop of Chicago (BillingSSJFX),359,NA,2000 Accounts Payable,217,6913.98,62225.82
4770 OCS Assessment,146,,,,,,,,,,,,
,,26055,,,,,,,,,,,
4780 Property/Casualty Insurance,390,,,,,,,,,,,,
,,73106.16,,,,,,,,,,,
,,,1/1/2021,Bill,8393,MR00157716,Catholic Bishop of Chicago (BillingSFXS),548,NA,2000 Accounts Payable,217,3609.44,76715.6
,,,1/1/2021,Bill,8396,MR00157745,Catholic Bishop of Chicago (BillingSJS),547,NA,2000 Accounts Payable,217,3970.38,80685.98
,,,1/1/2021,Bill,8389,MR00157900,Catholic Bishop of Chicago (BillingSSJFX),359,NA,2000 Accounts Payable,217,4451.64,85137.62
,,,1/29/2021,Bill,8587,IM00006661,Catholic Bishop of Chicago (BillingSJS),547,NA,2000 Accounts Payable,217,1967.48,87105.1
,,,1/29/2021,Bill,8578,IM00006659,Catholic Bishop of Chicago (BillingSSJFX),359,NA,2000 Accounts Payable,217,12883.52,99988.62
,,,1/29/2021,Bill,8562,IM00006660,Catholic Bishop of Chicago (BillingSFXS),548,NA,2000 Accounts Payable,217,19969.33,119957.95
,,,2/1/2021,Bill,8579,MR00158359,Catholic Bishop of Chicago (BillingSSJFX),359,NA,2000 Accounts Payable,217,6292.14,126250.09
,,,2/1/2021,Bill,8563,MR00158177,Catholic Bishop of Chicago (BillingSFXS),548,NA,2000 Accounts Payable,217,6462.2,132712.29
,,,2/1/2021,Bill,8588,MR00158205,Catholic Bishop of Chicago (BillingSJS),547,NA,2000 Accounts Payable,217,4251.45,136963.74
,,,3/1/2021,Bill,8564,MR00158636,Catholic Bishop of Chicago (BillingSFXS),548,NA,2000 Accounts Payable,217,6462.2,143425.94
,,,3/1/2021,Bill,8589,MR00158664,Catholic Bishop of Chicago (BillingSJS),547,NA,2000 Accounts Payable,217,4251.45,147677.39
,,,3/1/2021,Bill,8580,MR00158818,Catholic Bishop of Chicago (BillingSSJFX),359,NA,2000 Accounts Payable,217,6292.14,153969.53
4790 Auto Insur-Priest Owned Vehicle,72,,,,,,,,,,,,
,,3855,,,,,,,,,,,
4800 Miscellaneous,140,,,,,,,,,,,,
4802 Meetings & Speakers,NA,,,,,,,,,,,,
,,250,,,,,,,,,,,
,,,1/25/2021,Bill,8428,Helen PreJean talk,Ministry Against the Death Penalty,817,NA,2000 Accounts Payable,217,250,500
,,,2/9/2021,Bill,7183,Conf retreat speaker,James Wallace,560,NA,2000 Accounts Payable,217,300,800
,,,2/9/2021,Bill,8456,Lent Mission,IPS Scripture School,362,NA,2000 Accounts Payable,217,1500,2300
,,,2/22/2021,Bill,8521,Lenten retreat speak,Soul Play,370,NA,2000 Accounts Payable,217,350,2650
4803 Ministry Formation & Education,142,,,,,,,,,,,,
,,1725,,,,,,,,,,,
,,,2/17/2021,Bill,8566,AF00033858,Catholic Bishop of Chicago (BillingSSJFX),359,NA,2000 Accounts Payable,217,466.66,2191.66
,,,2/17/2021,Bill,8567,AF00033873,Catholic Bishop of Chicago (BillingSSJFX),359,NA,2000 Accounts Payable,217,466.66,2658.32
4804 Hospitality & Entertainment,138,,,,,,,,,,,,
,,387.77,,,,,,,,,,,
4805 Public Relations & Advertising,141,,,,,,,,,,,,
,,1195.86,,,,,,,,,,,
4806 Gifts & Donations,139,,,,,,,,,,,,
,,4781.25,,,,,,,,,,,
,,,1/12/2021,Bill,8381,reissue bonus chk,Edward Harnett,121,NA,2000 Accounts Payable,217,400,5181.25
,,,1/25/2021,Bill,8432,Donation,Catholic Extension,879,NA,2000 Accounts Payable,217,1000,6181.25
,,,2/9/2021,Bill,8454,RR h2o and more,Wayne Watts,241,NA,2000 Accounts Payable,217,284.6,6465.85
,,,2/23/2021,Bill,8547,RR gc and music,John Hopkins,101,NA,2000 Accounts Payable,217,50,6515.85
,,,2/23/2021,Bill,8543,RR ty gifts,Sarah Doran,700,NA,2000 Accounts Payable,217,300,6815.85
4807 Dues/Subscriptions,137,,,,,,,,,,,,
,,18861.82,,,,,,,,,,,
,,,1/11/2021,Bill,6574,RR Costco member,Joseph D'Arco,45,NA,2000 Accounts Payable,217,360,19221.82
,,,1/12/2021,Bill,8383,thru 2/5/2021,Chicago Tribune,222,acct: 30043892,2000 Accounts Payable,217,139.16,19360.98
,,,1/12/2021,Bill,8065,12/20-1/16/21,The New York Times,140,NA,2000 Accounts Payable,217,54,19414.98
,,,1/27/2021,Bill,8442,7027402199,"Savvas Learning Company, LLC",832,NA,2000 Accounts Payable,217,62.35,19477.33
,,,1/27/2021,Bill,8437,1/17 - 2/13,The New York Times,140,NA,2000 Accounts Payable,217,108,19585.33
,,,2/9/2021,Bill,8452,RR key/planner,John Hopkins,101,NA,2000 Accounts Payable,217,20,19605.33
,,,2/9/2021,Bill,8457,SJ thru 4/22,Chicago Tribune,222,NA,2000 Accounts Payable,217,132,19737.33
,,,2/22/2021,Bill,8508,annual dues,New Trier Multi-Faith Alliance,368,NA,2000 Accounts Payable,217,200,19937.33
,,,3/8/2021,Bill,8606,March dues,Chicago Tribune,222,NA,2000 Accounts Payable,217,136,20073.33
,,,3/8/2021,Bill,8624,2/14-3/13,The New York Times,140,NA,2000 Accounts Payable,217,6,20079.33
4808 Unrelated Business Tax,379,,,,,,,,,,,,
,,,2/23/2021,Journal Entry,11026,MD210223,NA,NA,REFUND FOR SALES TAX,-Split-,NA,-3.13,-3.13
4809 Special Program Expense,143,,,,,,,,,,,,
,,5285.31,,,,,,,,,,,
4820 Other Miscellaneous Expense,311,,,,,,,,,,,,
,,102125.93,,,,,,,,,,,
,,,1/12/2021,Bill,8061,RR Christmas gift,Wayne Watts,241,NA,2000 Accounts Payable,217,1828.75,103954.68
,,,1/12/2021,Bill,8061,RR Christmas gift,Wayne Watts,241,NA,2000 Accounts Payable,217,4267.09,108221.77
,,,2/22/2021,Bill,8529,13806,Meco Electric Company Inc.,147,Spiideo,2000 Accounts Payable,217,3182,111403.77
,,,3/10/2021,Bill,7194,FB squares,Scott Girard,375,NA,2000 Accounts Payable,217,800,112203.77
,,,3/10/2021,Bill,8633,RR,Wayne Watts,241,NA,2000 Accounts Payable,217,52.96,112256.73
,,,3/10/2021,Bill,7203,FB Squares,Brian Roselle,885,NA,2000 Accounts Payable,217,900,113156.73
,,,3/10/2021,Bill,7195,FB squares,Scott Dolan,376,NA,2000 Accounts Payable,217,200,113356.73
,,,3/10/2021,Bill,7196,FB Squares,Max Gunnill,377,NA,2000 Accounts Payable,217,800,114156.73
,,,3/10/2021,Bill,7197,FB Squares,Matt Lafontaine,378,NA,2000 Accounts Payable,217,300,114456.73
,,,3/10/2021,Bill,7198,FB Squares,Matt Hayes,379,NA,2000 Accounts Payable,217,600,115056.73
,,,3/10/2021,Bill,7199,FB Squares,Kieran Stack,380,NA,2000 Accounts Payable,217,300,115356.73
,,,3/10/2021,Bill,7202,FB Squares,Chris Farr,884,NA,2000 Accounts Payable,217,1100,116456.73
,,,3/10/2021,Bill,7201,FB Squares,Gil Calderon,883,NA,2000 Accounts Payable,217,100,116556.73
,,,3/10/2021,Bill,7200,FB Squares,James Slater,882,NA,2000 Accounts Payable,217,2400,118956.73
4820A Credit Card Expense - Needs Det,361,,,,,,,,,,,,
,,-5838.83,,,,,,,,,,,
5000 Insurance Recoveries,220,,,,,,,,,,,,
5001 Casualty Claims,NA,,,,,,,,,,,,
,,9560,,,,,,,,,,,
5010 Sharing Collections Oth Parish,516,,,,,,,,,,,,
5011 SS Joseph/Francis Xavier Sharin,NA,,,,,,,,,,,,
5011.1 St. VIncent de Paul,NA,,,,,,,,,,,,
,,42849,,,,,,,,,,,
,,,1/1/2021,Journal Entry,10581,GC 210101,NA,NA,NA,-Split-,NA,460,43309
,,,1/21/2021,Deposit,4166,NA,NA,NA,NA,1240.02 Oper. Savings at the Arch Bank:Stock Savings Account:SFX Stock/Mut Fund #701430250,651,500,43809
,,,1/31/2021,Journal Entry,10582,SUNC 210131,NA,NA,NA,-Split-,NA,1000,44809
,,,2/1/2021,Journal Entry,11028,GC FEB 2021,NA,NA,NA,-Split-,NA,360,45169
,,,2/28/2021,Journal Entry,10802,SUN210228,NA,NA,NA,-Split-,NA,140,45309
5012 St Joseph Sharing,424,,,,,,,,,,,,
5012.02 St. Ignatius,NA,,,,,,,,,,,,
,,10142,,,,,,,,,,,
,,,1/1/2021,Journal Entry,10581,GC 210101,NA,NA,NA,-Split-,NA,280,10422
,,,1/3/2021,Journal Entry,10570,SUN 210103,NA,NA,NA,-Split-,NA,8,10430
,,,1/7/2021,Journal Entry,10586,210107 MD,NA,NA,NA,-Split-,NA,30,10460
,,,1/10/2021,Journal Entry,10572,SPEC 210110,NA,NA,NA,-Split-,NA,705,11165
,,,1/17/2021,Journal Entry,10575,SUN 210117,NA,NA,NA,-Split-,NA,265,11430
,,,1/24/2021,Journal Entry,10578,SUN 210124,NA,NA,NA,-Split-,NA,70,11500
,,,1/31/2021,Journal Entry,10582,SUNC 210131,NA,NA,NA,-Split-,NA,345,11845
,,,2/1/2021,Journal Entry,11028,GC FEB 2021,NA,NA,NA,-Split-,NA,165,12010
,,,2/3/2021,Journal Entry,10583,MD 210203,NA,NA,NA,-Split-,NA,25,12035
,,,2/7/2021,Journal Entry,10783,SUN 210207,NA,NA,NA,-Split-,NA,497,12532
,,,2/11/2021,Journal Entry,11024,md210211,NA,NA,NA,-Split-,NA,100,12632
,,,2/14/2021,Journal Entry,10799,SUN210214,NA,NA,NA,-Split-,NA,405,13037
,,,2/19/2021,Journal Entry,11025,MD210219,NA,NA,NA,-Split-,NA,135,13172
,,,2/21/2021,Journal Entry,10800,SUN210221,NA,NA,NA,-Split-,NA,210,13382
,,,2/24/2021,Journal Entry,11027,MD210224,NA,NA,NA,-Split-,NA,10,13392
,,,2/28/2021,Journal Entry,10802,SUN210228,NA,NA,NA,-Split-,NA,610,14002
5013 St Francis Xavier Sharing,421,,,,,,,,,,,,
5013.01 St. Thomas of Canterbury,NA,,,,,,,,,,,,
,,39150,,,,,,,,,,,
,,,1/1/2021,Journal Entry,10581,GC 210101,NA,NA,soup kitchen,-Split-,NA,350,39500
,,,1/1/2021,Journal Entry,10581,GC 210101,NA,NA,NA,-Split-,NA,1362,40862
,,,1/3/2021,Journal Entry,10570,SUN 210103,NA,NA,NA,-Split-,NA,317,41179
,,,1/10/2021,Journal Entry,10572,SPEC 210110,NA,NA,NA,-Split-,NA,195,41374
,,,1/12/2021,Journal Entry,10574,MD 210112,NA,NA,NA,-Split-,NA,100,41474
,,,1/17/2021,Journal Entry,10575,SUN 210117,NA,NA,NA,-Split-,NA,926,42400
,,,1/24/2021,Journal Entry,10578,SUN 210124,NA,NA,NA,-Split-,NA,20,42420
,,,1/31/2021,Journal Entry,10582,SUNC 210131,NA,NA,NA,-Split-,NA,245,42665
,,,2/1/2021,Journal Entry,11028,GC FEB 2021,NA,NA,NA,-Split-,NA,1277,43942
,,,2/1/2021,Journal Entry,11028,GC FEB 2021,NA,NA,soup kitchen,-Split-,NA,150,44092
,,,2/3/2021,Journal Entry,10583,MD 210203,NA,NA,NA,-Split-,NA,405,44497
,,,2/7/2021,Journal Entry,10783,SUN 210207,NA,NA,NA,-Split-,NA,101,44598
,,,2/11/2021,Journal Entry,11024,md210211,NA,NA,NA,-Split-,NA,90,44688
,,,2/19/2021,Journal Entry,11025,MD210219,NA,NA,NA,-Split-,NA,40,44728
,,,2/23/2021,Journal Entry,11026,MD210223,NA,NA,NA,-Split-,NA,500,45228
,,,2/24/2021,Journal Entry,11027,MD210224,NA,NA,NA,-Split-,NA,60,45288
,,,2/28/2021,Journal Entry,10802,SUN210228,NA,NA,NA,-Split-,NA,850,46138
5015 Sharing Collections Outside AOC,422,,,,,,,,,,,,
5016 Immaculate Conception-Haiti,NA,,,,,,,,,,,,
,,21087,,,,,,,,,,,
,,,1/1/2021,Journal Entry,10581,GC 210101,NA,NA,NA,-Split-,NA,805,21892
,,,1/3/2021,Journal Entry,10570,SUN 210103,NA,NA,NA,-Split-,NA,547,22439
,,,1/7/2021,Journal Entry,10586,210107 MD,NA,NA,NA,-Split-,NA,10,22449
,,,1/10/2021,Journal Entry,10572,SPEC 210110,NA,NA,NA,-Split-,NA,550,22999
,,,1/12/2021,Journal Entry,10574,MD 210112,NA,NA,NA,-Split-,NA,100,23099
,,,1/17/2021,Journal Entry,10575,SUN 210117,NA,NA,NA,-Split-,NA,360,23459
,,,1/18/2021,Journal Entry,10576,MD 210118,NA,NA,NA,-Split-,NA,500,23959
,,,1/22/2021,Journal Entry,10577,MD 210122,NA,NA,NA,-Split-,NA,1000,24959
,,,1/24/2021,Journal Entry,10578,SUN 210124,NA,NA,NA,-Split-,NA,45,25004
,,,1/31/2021,Journal Entry,10582,SUNC 210131,NA,NA,NA,-Split-,NA,325,25329
,,,2/1/2021,Journal Entry,11028,GC FEB 2021,NA,NA,NA,-Split-,NA,1445,26774
,,,2/3/2021,Journal Entry,10583,MD 210203,NA,NA,NA,-Split-,NA,145,26919
,,,2/7/2021,Journal Entry,10783,SUN 210207,NA,NA,NA,-Split-,NA,454,27373
,,,2/11/2021,Journal Entry,11024,md210211,NA,NA,NA,-Split-,NA,120,27493
,,,2/14/2021,Journal Entry,10799,SUN210214,NA,NA,NA,-Split-,NA,480,27973
,,,2/19/2021,Journal Entry,11025,MD210219,NA,NA,NA,-Split-,NA,65,28038
,,,2/21/2021,Journal Entry,10800,SUN210221,NA,NA,NA,-Split-,NA,35,28073
,,,2/23/2021,Journal Entry,11026,MD210223,NA,NA,NA,-Split-,NA,500,28573
,,,2/24/2021,Journal Entry,11027,MD210224,NA,NA,NA,-Split-,NA,90,28663
,,,2/28/2021,Journal Entry,10802,SUN210228,NA,NA,NA,-Split-,NA,120,28783
5016C IC Secial Fundraising,547,,,,,,,,,,,,
,,40000,,,,,,,,,,,
5017 Haiti-Rodlin,248,,,,,,,,,,,,
,,4202.95,,,,,,,,,,,
5030 Arch Required Collections,81,,,,,,,,,,,,
5031 Latin America,NA,,,,,,,,,,,,
,,,1/1/2021,Journal Entry,10581,GC 210101,NA,NA,NA,-Split-,NA,360,360
,,,1/10/2021,Journal Entry,10572,SPEC 210110,NA,NA,NA,-Split-,NA,75,435
,,,1/17/2021,Journal Entry,10575,SUN 210117,NA,NA,NA,-Split-,NA,20,455
,,,1/24/2021,Journal Entry,10578,SUN 210124,NA,NA,NA,-Split-,NA,590,1045
,,,1/31/2021,Journal Entry,10582,SUNC 210131,NA,NA,NA,-Split-,NA,100,1145
,,,2/1/2021,Journal Entry,11028,GC FEB 2021,NA,NA,NA,-Split-,NA,15,1160
,,,2/3/2021,Journal Entry,10583,MD 210203,NA,NA,NA,-Split-,NA,50,1210
,,,2/7/2021,Journal Entry,10783,SUN 210207,NA,NA,NA,-Split-,NA,26,1236
,,,2/11/2021,Journal Entry,11024,md210211,NA,NA,NA,-Split-,NA,30,1266
,,,2/14/2021,Journal Entry,10799,SUN210214,NA,NA,NA,-Split-,NA,35,1301
,,,2/28/2021,Journal Entry,10802,SUN210228,NA,NA,NA,-Split-,NA,100,1401
5032 Seminaries,87,,,,,,,,,,,,
,,2930,,,,,,,,,,,
,,,1/3/2021,Journal Entry,10570,SUN 210103,NA,NA,NA,-Split-,NA,5,2935
,,,2/28/2021,Journal Entry,10802,SUN210228,NA,NA,NA,-Split-,NA,100,3035
5033 Annual Catholic Appeal,82,,,,,,,,,,,,
,,-1132,,,,,,,,,,,
5034 Holy Land,83,,,,,,,,,,,,
,,55,,,,,,,,,,,
,,,2/28/2021,Journal Entry,10802,SUN210228,NA,NA,NA,-Split-,NA,65,120
5035 Aid Churches Centl/East Europe,86,,,,,,,,,,,,
,,1050,,,,,,,,,,,
,,,2/1/2021,Journal Entry,11028,GC FEB 2021,NA,NA,NA,-Split-,NA,100,1150
,,,2/3/2021,Journal Entry,10583,MD 210203,NA,NA,NA,-Split-,NA,25,1175
,,,2/11/2021,Journal Entry,11024,md210211,NA,NA,NA,-Split-,NA,80,1255
,,,2/28/2021,Journal Entry,10802,SUN210228,NA,NA,NA,-Split-,NA,530,1785
5036 Catholic Charities,84,,,,,,,,,,,,
,,990,,,,,,,,,,,
,,,1/1/2021,Journal Entry,10581,GC 210101,NA,NA,NA,-Split-,NA,100,1090
,,,1/31/2021,Journal Entry,10582,SUNC 210131,NA,NA,NA,-Split-,NA,20,1110
,,,2/1/2021,Journal Entry,11028,GC FEB 2021,NA,NA,NA,-Split-,NA,800,1910
,,,2/28/2021,Journal Entry,10802,SUN210228,NA,NA,NA,-Split-,NA,150,2060
5037 Peter's Pence,85,,,,,,,,,,,,
,,730,,,,,,,,,,,
,,,2/28/2021,Journal Entry,10802,SUN210228,NA,NA,NA,-Split-,NA,25,755
5039 World Mission Sunday,88,,,,,,,,,,,,
,,2068,,,,,,,,,,,
,,,1/3/2021,Journal Entry,10570,SUN 210103,NA,NA,NA,-Split-,NA,5,2073
,,,2/28/2021,Journal Entry,10802,SUN210228,NA,NA,NA,-Split-,NA,75,2148
5040 Cath Campaign for Human Develop,89,,,,,,,,,,,,
,,5085,,,,,,,,,,,
,,,2/14/2021,Journal Entry,10799,SUN210214,NA,NA,NA,-Split-,NA,75,5160
,,,2/19/2021,Journal Entry,11025,MD210219,NA,NA,NA,-Split-,NA,20,5180
,,,2/24/2021,Journal Entry,11027,MD210224,NA,NA,NA,-Split-,NA,10,5190
,,,2/28/2021,Journal Entry,10802,SUN210228,NA,NA,NA,-Split-,NA,50,5240
5041 Religious Retirement,90,,,,,,,,,,,,
,,4441,,,,,,,,,,,
,,,1/1/2021,Journal Entry,10581,GC 210101,NA,NA,NA,-Split-,NA,100,4541
,,,1/3/2021,Journal Entry,10570,SUN 210103,NA,NA,NA,-Split-,NA,150,4691
,,,2/1/2021,Journal Entry,11028,GC FEB 2021,NA,NA,NA,-Split-,NA,275,4966
,,,2/28/2021,Journal Entry,10802,SUN210228,NA,NA,NA,-Split-,NA,100,5066
5042 Missionary CO-OP Plan,218,,,,,,,,,,,,
,,415,,,,,,,,,,,
,,,2/1/2021,Journal Entry,11028,GC FEB 2021,NA,NA,NA,-Split-,NA,500,915
,,,2/28/2021,Journal Entry,10802,SUN210228,NA,NA,NA,-Split-,NA,25,940
5044 Archdiocesan Priest Retirement,297,,,,,,,,,,,,
,,3010,,,,,,,,,,,
,,,2/28/2021,Journal Entry,10802,SUN210228,NA,NA,NA,-Split-,NA,50,3060
"5050 Estates, Bequests & Memorials",204,,,,,,,,,,,,
5052 Bequests Proceeds,NA,,,,,,,,,,,,
,,20000,,,,,,,,,,,
5053 Memorial Proceeds,205,,,,,,,,,,,,
,,130,,,,,,,,,,,
,,,1/1/2021,Journal Entry,10581,GC 210101,NA,NA,NA,-Split-,NA,1025,1155
,,,2/1/2021,Journal Entry,11028,GC FEB 2021,NA,NA,NA,-Split-,NA,545,1700
,,,2/7/2021,Journal Entry,10783,SUN 210207,NA,NA,PJP MEMORIAL,-Split-,NA,100,1800
,,,2/11/2021,Journal Entry,11024,md210211,NA,NA,NA,-Split-,NA,170,1970
,,,2/28/2021,Journal Entry,10802,SUN210228,NA,NA,PJP MEMORIAL,-Split-,NA,100,2070
5060 Other Extraordinary Income,207,,,,,,,,,,,,
5061 Other Extraordinary Collections,NA,,,,,,,,,,,,
,,255,,,,,,,,,,,
5065 Other Extraordinary Income,427,,,,,,,,,,,,
,,200673.98,,,,,,,,,,,
,,,1/8/2021,Deposit,4168,NA,NA,NA,covid fee,1101.10 Cash:Saints JFX Oper. Acct. #2264:Checking Available,691,200,200873.98
,,,1/15/2021,Deposit,4169,NA,NA,NA,covid fee,1101.10 Cash:Saints JFX Oper. Acct. #2264:Checking Available,691,100,200973.98
,,,1/25/2021,Deposit,4171,NA,NA,NA,covid fee,1101.10 Cash:Saints JFX Oper. Acct. #2264:Checking Available,691,40,201013.98
,,,1/29/2021,Deposit,4177,NA,NA,NA,covid fee,1101.10 Cash:Saints JFX Oper. Acct. #2264:Checking Available,691,200,201213.98
,,,2/19/2021,Deposit,4457,NA,NA,NA,covid fee,1101.10 Cash:Saints JFX Oper. Acct. #2264:Checking Available,691,100,201313.98
,,,2/25/2021,Deposit,4459,NA,NA,NA,covid fee,1101.10 Cash:Saints JFX Oper. Acct. #2264:Checking Available,691,100,201413.98
5110 Fund Collections,223,,,,,,,,,,,,
5112 Parish Endow Fund Collection,NA,,,,,,,,,,,,
,,-7625,,,,,,,,,,,
5113 Parish Ed. Endow Fund Collect,221,,,,,,,,,,,,
,,10510.97,,,,,,,,,,,
,,,2/11/2021,Journal Entry,10796,SCH210211,NA,NA,NA,-Split-,NA,350,10860.97
5114 Annual Appeal Rebate,160,,,,,,,,,,,,
,,23516.9,,,,,,,,,,,
"5115 ""To Teach Who Christ Is"" Campgn",430,,,,,,,,,,,,
5115.01 St Joseph TTWCI Campaign,NA,,,,,,,,,,,,
,,17044.5,,,,,,,,,,,
5115.02 St Francis Xavier TTWCI Campagn,431,,,,,,,,,,,,
,,107071.91,,,,,,,,,,,
,,,1/4/2021,Deposit,4441,NA,NA,NA,NA,101.25G Cash:Saints JFX Oper. Acct. #2264:Checking Restricted:Church Restricted:TTWCI,665,50000,157071.91
,,,1/12/2021,Bill,8382,donation,To Teach Who Christ Is,559,NA,2000 Accounts Payable,217,-50000,107071.91
5120 Capital Collections,77,,,,,,,,,,,,
5122 Church Building Fund,NA,,,,,,,,,,,,
,,187363.63,,,,,,,,,,,
,,,1/1/2021,Journal Entry,10581,GC 210101,NA,NA,capital projects,-Split-,NA,850,188213.63
,,,1/3/2021,Journal Entry,10570,SUN 210103,NA,NA,NA,-Split-,NA,7,188220.63
,,,1/7/2021,Journal Entry,10586,210107 MD,NA,NA,NA,-Split-,NA,10020,198240.63
,,,1/10/2021,Journal Entry,10573,SUN 200110,NA,NA,SFX memorials non specific,-Split-,NA,1390,199630.63
,,,1/12/2021,Journal Entry,10574,MD 210112,NA,NA,NA,-Split-,NA,5500,205130.63
,,,1/17/2021,Journal Entry,10575,SUN 210117,NA,NA,NA,-Split-,NA,25,205155.63
,,,1/18/2021,Journal Entry,10576,MD 210118,NA,NA,NA,-Split-,NA,1000,206155.63
,,,2/1/2021,Journal Entry,11028,GC FEB 2021,NA,NA,capital projects,-Split-,NA,15,206170.63
6010 Share Collect Pay to Oth Parish,517,,,,,,,,,,,,
6011 SS Joseph/Francis Xavier Sharin,NA,,,,,,,,,,,,
6011.01 St. Vincent de Paul,NA,,,,,,,,,,,,
,,34951,,,,,,,,,,,
,,,3/10/2021,Bill,8648,collections,St. Vincent De Paul,249,NA,2000 Accounts Payable,217,13302,48253
6012 St. Joseph Sharing,702,,,,,,,,,,,,
6012.02 St. Ignatius,NA,,,,,,,,,,,,
,,500,,,,,,,,,,,
6013 St Francis Xavier Sharing,616,,,,,,,,,,,,
6013.01 St. Thomas of Canterbury,NA,,,,,,,,,,,,
,,29546.5,,,,,,,,,,,
,,,3/10/2021,Bill,8649,collections,St. Thomas of Canterbury School,338,NA,2000 Accounts Payable,217,28221,57767.5
6015 Sharing Outside the AOC,426,,,,,,,,,,,,
6016 Immaculate Conception-Haiti,NA,,,,,,,,,,,,
,,4942.5,,,,,,,,,,,
6016A IC Normal School Support,542,,,,,,,,,,,,
,,15950.93,,,,,,,,,,,
,,,1/7/2021,Journal Entry,10584,wire transf,NA,NA,NA,-Split-,NA,7559,23509.93
6016B IC Special School Support,543,,,,,,,,,,,,
,,57035,,,,,,,,,,,
6016C IC Parish Support,544,,,,,,,,,,,,
,,,1/11/2021,Bill,6576,RR barrel shipping,Mike Henn,79,NA,2000 Accounts Payable,217,4060,4060
6016D IT Superintendent Support,545,,,,,,,,,,,,
,,3000,,,,,,,,,,,
6016E Scholorships,555,,,,,,,,,,,,
,,14306,,,,,,,,,,,
6017 Haiti Fr. Rodlin,251,,,,,,,,,,,,
,,8000,,,,,,,,,,,
6030 Pymt Arch Required Collections,172,,,,,,,,,,,,
6031 Latin America,NA,,,,,,,,,,,,
,,485,,,,,,,,,,,
6032 Seminaries,178,,,,,,,,,,,,
,,10,,,,,,,,,,,
,,,2/10/2021,Bill,8465,collections,Seminarian Collection,592,NA,2000 Accounts Payable,217,2935,2945
6034 Holy Land,174,,,,,,,,,,,,
,,1245,,,,,,,,,,,
6035 Aid Churches Centl/East Europe,177,,,,,,,,,,,,
,,5022,,,,,,,,,,,
,,,2/10/2021,Bill,8467,collections,Department of Stewardship and Development,323,NA,2000 Accounts Payable,217,1050,6072
6036 Catholic Charities,175,,,,,,,,,,,,
,,3455.52,,,,,,,,,,,
,,,2/10/2021,Bill,8466,collections,Catholic Charities,35,NA,2000 Accounts Payable,217,1216,4671.52
6037 Peter's Pence,176,,,,,,,,,,,,
,,3143,,,,,,,,,,,
6039 World Mission Sunday,179,,,,,,,,,,,,
,,230,,,,,,,,,,,
,,,2/10/2021,Bill,8468,collections,Society of Propagation of Faith,593,NA,2000 Accounts Payable,217,1988,2218
6040 Cath Campaign for Human Develop,180,,,,,,,,,,,,
,,,2/10/2021,Bill,8464,collections,Catholic Campaign for Human Development,365,NA,2000 Accounts Payable,217,4665,4665
6041 Religious Retirement,181,,,,,,,,,,,,
,,,2/10/2021,Bill,8469,collections,Retirement Fund for Religious,364,NA,2000 Accounts Payable,217,1863.42,1863.42
6044 Archdiocesan Priest Retirement,296,,,,,,,,,,,,
,,4510,,,,,,,,,,,
,,,2/9/2021,Bill,8463,collections,Priests' Health and Retirement,324,NA,2000 Accounts Payable,217,2650,7160
6060 Other Extraordinary Expenses,183,,,,,,,,,,,,
,,327.72,,,,,,,,,,,
6061 Real Estate Taxes,193,,,,,,,,,,,,
,,6098.01,,,,,,,,,,,
6063 Other Extraordinary Expenses,637,,,,,,,,,,,,
,,311941.03,,,,,,,,,,,
,,,1/11/2021,Bill,6575,RR heaters at SFXS,Mike Henn,79,COVID heaters,2000 Accounts Payable,217,2090.5,314031.53
,,,1/11/2021,Bill,6587,1002,Merbeth Metal Products Inc,866,COVID heater brackets,2000 Accounts Payable,217,580,314611.53
,,,1/12/2021,Bill,8077,covid shields,James Bui,873,COVID,2000 Accounts Payable,217,200,314811.53
,,,1/27/2021,Bill,8438,RR Covid test,Pamela Elliot,880,NA,2000 Accounts Payable,217,139,314950.53
,,,1/29/2021,Journal Entry,10585,wire transf,NA,NA,new crucifix,-Split-,NA,2349.75,317300.28
,,,2/9/2021,Bill,7160,RR tents,Tom Grenke,826,NA,2000 Accounts Payable,217,25.62,317325.9
,,,2/9/2021,Bill,7178,RR Covid expenses,Joseph D'Arco,45,Covid,2000 Accounts Payable,217,661.36,317987.26
,,,2/9/2021,Bill,7178,RR Covid expenses,Joseph D'Arco,45,Covid,2000 Accounts Payable,217,661.37,318648.63
,,,2/10/2021,Bill,8474,C2429302,Altorfer Industries Inc,867,covid,2000 Accounts Payable,217,8193,326841.63
,,,2/10/2021,Bill,8471,C2440401,Altorfer Industries Inc,867,covid,2000 Accounts Payable,217,3410,330251.63
,,,2/22/2021,Bill,8527,13803,Meco Electric Company Inc.,147,COVID,2000 Accounts Payable,217,1284.5,331536.13
,,,2/22/2021,Bill,8526,13804,Meco Electric Company Inc.,147,COVID,2000 Accounts Payable,217,2995,334531.13
,,,2/22/2021,Bill,8525,807,Meco Electric Company Inc.,147,COVID,2000 Accounts Payable,217,3338,337869.13
,,,2/22/2021,Bill,8523,1.51979E+11,Office Depot Business Credit,139,COVID,2000 Accounts Payable,217,99.9,337969.03
,,,2/22/2021,Bill,8518,68990,Crescent Cleaning Company,820,COVID,2000 Accounts Payable,217,219.98,338189.01
,,,2/22/2021,Bill,8519,69164,Crescent Cleaning Company,820,COVID,2000 Accounts Payable,217,219.98,338408.99
,,,2/23/2021,Bill,8530,13808,Meco Electric Company Inc.,147,COVID,2000 Accounts Payable,217,1484,339892.99
,,,3/8/2021,Bill,8623,C2429303,Altorfer Industries Inc,867,NA,2000 Accounts Payable,217,9529,349421.99
,,,3/8/2021,Bill,8622,C2440402,Altorfer Industries Inc,867,NA,2000 Accounts Payable,217,3267,352688.99
6064 Prior Year Adjustments,309,,,,,,,,,,,,
,,-107155.37,,,,,,,,,,,
6110 Capital Improvements,661,,,,,,,,,,,,
6112 St Joseph Campus Cap Improvemnt,NA,,,,,,,,,,,,
6112.01 SJ Church Sound System Upgrade,NA,,,,,,,,,,,,
,,957.81,,,,,,,,,,,
6112.02 Church Lighting Project,594,,,,,,,,,,,,
,,21425.4,,,,,,,,,,,
6112.06 School Security,627,,,,,,,,,,,,
,,33304.3,,,,,,,,,,,
6112.07 SJ Parking lot project,628,,,,,,,,,,,,
,,8329.89,,,,,,,,,,,
6112.08 Church Masonry,629,,,,,,,,,,,,
,,,2/23/2021,Bill,8531,10359,"Holton Brothers, Inc",643,NA,2000 Accounts Payable,217,9270,9270
6113 SFX Campus Cap Improvement,512,,,,,,,,,,,,
6113.02 SFX Church Improvements,NA,,,,,,,,,,,,
,,109446.38,,,,,,,,,,,
,,,1/25/2021,Bill,8408,church doors,"Virgil James, Inc",320,NA,2000 Accounts Payable,217,36112.16,145558.54
,,,2/19/2021,Journal Entry,11025,MD210219,NA,NA,HEARING LOOP,-Split-,NA,-1487.31,144071.23
,,,2/23/2021,Bill,8533,Marble,"Tile Decor, Inc",371,NA,2000 Accounts Payable,217,1070,145141.23
,,,2/23/2021,Bill,8534,caulking,"Bruno Construction Masonry, Inc",372,NA,2000 Accounts Payable,217,2600,147741.23
,,,3/10/2021,Bill,7184,SFX doors final,"Virgil James, Inc",320,NA,2000 Accounts Payable,217,20676.82,168418.05
6113.03 SFX Church Carpet,515,,,,,,,,,,,,
,,50000,,,,,,,,,,,
6113.04 SFX Parking lot project,554,,,,,,,,,,,,
,,4356.66,,,,,,,,,,,
6113.05 Church Masonry,557,,,,,,,,,,,,
,,,2/23/2021,Bill,8532,10367,"Holton Brothers, Inc",643,NA,2000 Accounts Payable,217,6590,6590
Not Specified,NA,,,,,,,,,,,,
,,,1/3/2021,Journal Entry,10570,SUN 210103,NA,NA,NA,-Split-,NA,NA,NA
,,,1/7/2021,Journal Entry,10586,210107 MD,NA,NA,NA,-Split-,NA,NA,NA
,,,1/10/2021,Journal Entry,10572,SPEC 210110,NA,NA,NA,-Split-,NA,NA,NA
,,,1/10/2021,Journal Entry,10573,SUN 200110,NA,NA,NA,-Split-,NA,0,0
,,,1/10/2021,Journal Entry,10573,SUN 200110,NA,NA,NA,-Split-,NA,NA,0
,,,1/12/2021,Journal Entry,10574,MD 210112,NA,NA,NA,-Split-,NA,NA,0
,,,1/17/2021,Journal Entry,10575,SUN 210117,NA,NA,NA,-Split-,NA,NA,0
,,,1/18/2021,Journal Entry,10576,MD 210118,NA,NA,NA,-Split-,NA,NA,0
,,,1/22/2021,Journal Entry,10577,MD 210122,NA,NA,NA,-Split-,NA,NA,0
,,,1/24/2021,Journal Entry,10578,SUN 210124,NA,NA,NA,-Split-,NA,NA,0
,,,1/31/2021,Journal Entry,10582,SUNC 210131,NA,NA,NA,-Split-,NA,NA,0
,,,2/3/2021,Journal Entry,10583,MD 210203,NA,NA,NA,-Split-,NA,NA,0
,,,2/7/2021,Journal Entry,10783,SUN 210207,NA,NA,NA,-Split-,NA,0,0
,,,2/7/2021,Journal Entry,10783,SUN 210207,NA,NA,NA,-Split-,NA,NA,0
,,,2/11/2021,Journal Entry,11024,md210211,NA,NA,NA,-Split-,NA,NA,0
,,,2/11/2021,Journal Entry,10796,SCH210211,NA,NA,NA,-Split-,NA,NA,0
,,,2/14/2021,Journal Entry,10799,SUN210214,NA,NA,NA,-Split-,NA,NA,0
,,,2/19/2021,Journal Entry,11025,MD210219,NA,NA,NA,-Split-,NA,NA,0
,,,2/21/2021,Journal Entry,10800,SUN210221,NA,NA,NA,-Split-,NA,NA,0
,,,2/23/2021,Journal Entry,11026,MD210223,NA,NA,NA,-Split-,NA,NA,0
,,,2/24/2021,Journal Entry,11027,MD210224,NA,NA,NA,-Split-,NA,NA,0
,,,2/28/2021,Journal Entry,10802,SUN210228,NA,NA,NA,-Split-,NA,NA,0
